GCA_024166365.1	mEleMax1	Elephas maximus indicus	64	3401247148	53144486.69	127432672	141759744.31	10	243826021	1881	190	3397913467	17883755.09	87987108	93553859.59	13	208165719	1881	126	3333681	26457.79	810570	706466.31	2	956684	13	1000898867:698528178:699222697:999263725	41.14	1636266381	190	3397913467	17883755.09	126	64
GCA_030014295.1	mLoxAfr1	Loxodonta africana	880	3540893228	4023742.30	119600562	129447918.41	11	241857137	12354	1111	3537204660	3183802.57	82653632	82032818.41	15	229222375	12354	231	3688568	15967.83	298901	494043.51	3	1137416	13	1037882257:729579195:729363207:1040380001	41.25	1731632144	1111	3537204660	3183802.57	231	880
GCA_028571685.1	mHetBru1	Heterohyrax brucei	62	3488059404	56259022.65	139648372	147102587.04	10	223965608	17888	338	3487990716	10319499.16	78495281	87098231.78	14	193784397	4886	276	68688	248.87	200	404.71	101	2374	20	1031544906:711995122:711030752:1033419936	40.80	1584186748	338	3487990716	10319499.16	276	62
GCA_030035585.1	mDugDug1	Dugong dugon	198	3158488110	15951960.15	140670990	149727175.06	9	230923939	6772	294	3158468910	10743091.53	57632671	71297885.89	17	162184114	6772	96	19200	200.00	200	200.00	48	200	200	937424608:641926225:641856437:937261640	40.65	1480584537	294	3158468910	10743091.53	96	198
GCA_046562895.1	mTriInu1	Trichechus inunguis	401	3320339069	8280147.30	123530250	135593633.67	10	231286350	9447	695	3320280269	4777381.68	25109643	26065586.68	45	61973209	9447	294	58800	200.00	200	200.00	147	200	200	982277596:677252632:677285706:983464335	40.80	1605263663	695	3320280269	4777381.68	294	401
GCA_043290085.1	mRhyPet1	Rhynchocyon petersi	469	5620370870	11983733.20	521973465	535918064.42	5	866991485	13901	1239	5620217039	4536091.23	13617243	18063465.40	118	67838716	13901	770	153831	199.78	200	199.97	385	200	31	1636725523:1172619792:1172988016:1637883708	41.74	3589611769	1239	5620217039	4536091.23	770	469
GCA_023851605.1	mTamTet1	Tamandua tetradactyla	201	3205741135	15948960.87	174634624	144321420.34	8	234425570	513	1162	3187843721	2743411.12	9869167	12523170.30	91	46629633	18	961	17897414	18623.74	314612	378653.54	17	958708	12	964526045:628962310:629547932:964807434	39.48	1280156520	1162	3187843721	2743411.12	961	201
GCA_015220235.1	mChoDid1	Choloepus didactylus	146	3214702604	22018510.99	146178362	146565942.07	9	250664781	2025	1386	3133710200	2260974.17	20994632	23191139.26	45	67722938	60	1240	80992404	65316.45	632029	852492.09	36	2960333	9	942312141:624942655:624959886:941495518	39.89	1283258491	1386	3133710200	2260974.17	1240	146
GCA_030445035.2	mDasNov1	Dasypus novemcinctus	546	3610552089	6612732.76	127081865	124800058.28	12	209551734	13962	1339	3598802131	2687678.96	13963394	19830138.73	68	82498337	13962	793	11749958	14817.10	222765	521063.57	11	1693271	13	1061943998:737779997:737685657:1061392479	41.00	1551838002	1339	3598802131	2687678.96	793	546
GCA_009914755.4	T2T-CHM13v2.0	Homo sapiens	25	3117292070	124691682.80	150617247	154570748.05	9	248387328	16569	25	3117292070	124691682.80	150617247	154570748.05	9	248387328	16569	0	0	0.00	0	0.00	0	0	0	923878813:633696734:636722544:922993979	40.75	1255459380	25	3117292070	124691682.80	0	25
GCA_028858775.2	mPanTro3	Pan troglodytes	25	3177739762	127109590.48	146288486	146132230.01	9	231299448	36447294	30	3172739762	105757992.07	146288486	145701640.96	9	231299448	1222408	5	5000000	1000000.00	1000000	1000000.00	3	1000000	1000000	945788161:647621999:639501015:939828587	40.57	1322542809	30	3172739762	105757992.07	5	25
GCA_029289425.3	mPanPan1	Pan paniscus	31	3244905268	104674363.48	147028407	148058124.42	9	227705052	16560	37	3239870268	87564061.30	147028407	147607449.89	9	227705052	16560	6	5035000	839166.67	1000000	993291.96	3	1000000	35000	972551433:659642974:650396336:957279525	40.43	1381846802	37	3239870268	87564061.30	6	31
GCA_029281585.3	mGorGor1	Gorilla gorilla	26	3545850631	136378870.42	150804130	158682750.62	10	243847345	16407	28	3543850631	126566093.96	150804130	158555828.22	10	243847345	16407	2	2000000	1000000.00	1000000	1000000.00	1	1000000	1000000	1052156165:723071874:711787386:1056835206	40.49	1674795142	28	3543850631	126566093.96	2	26
GCA_028885655.2	mPonAbe1	Pongo abelii 	29	3259853530	112408742.41	146197178	148699323.48	9	233795519	115212	40	3251792274	81294806.85	146197178	147232458.59	9	233652841	77701	11	8061256	732841.45	1000000	992682.11	5	1000000	5000	959799278:667931815:661499209:962561972	40.88	1376295108	40	3251792274	81294806.85	11	29
GCA_028885625.2	mPonPyg2	Pongo pygmaeus	25	3220935163	128837406.52	143261986	147085828.95	9	230807400	49419398	33	3212935163	97361671.61	140592248	145969953.59	9	230807400	1283277	8	8000000	1000000.00	1000000	1000000.00	4	1000000	1000000	948523909:659556720:653821402:951033132	40.88	1338871812	33	3212935163	97361671.61	8	25
GCA_028878055.3	mSymSyn1	Symphalangus syndactylus	27	3262904223	120848304.56	146713733	135678961.74	11	167654734	16515	28	3261904223	116496579.39	146713733	135617642.72	11	167654734	16515	1	1000000	1000000.00	1000000	1000000.00	1	1000000	1000000	970402456:660291668:658228743:972981356	40.42	1483711519	28	3261904223	116496579.39	1	27
GCA_037993035.1	T2T-MFA8v1.0	Macaca fascicularis	22	3042930936	138315042.55	162126771	158335300.00	8	234122563	16561	22	3042930936	138315042.55	162126771	158335300.00	8	234122563	16561	0	0	0.00	0	0.00	0	0	0	895761531:624062284:624977314:898129807	41.05	1221896770	22	3042930936	138315042.55	0	22
GCA_043159975.1	mMacNem1	Macaca nemestrina	362	3116305216	8608577.94	154799650	154004014.76	9	233354531	12482	622	3116259816	5010064.01	40835442	45178576.26	24	123176650	11874	260	45400	174.62	200	185.46	114	200	100	918341527:639287429:639756411:918874449	41.04	1279410146	622	3116259816	5010064.01	260	362
GCA_049354715.1	mCalJac2	Callithrix jacchus	24	2933409465	122225394.38	141933726	145399576.35	9	220781134	15860301	27	2933238032	108638445.63	137132494	140629843.74	9	220781134	135793	3	171433	57144.33	100000	82502.66	1	100000	7500	867215630:598413356:599419833:868189213	40.84	1143654513	27	2933238032	108638445.63	3	24
GCA_048565385.1	mSaiBol1	Saimiri boliviensis	63	2747476440	43610737.14	129414808	152256898.95	8	302010752	16472	136	2747463640	20201938.53	69222429	76553852.62	13	163697774	16472	73	12800	175.34	200	185.94	32	200	100	810532957:563070190:563380085:810480408	41.00	1036518098	136	2747463640	20201938.53	73	63
GCA_027406575.1	mNycCou1	Nycticebus coucang	85	2917170805	34319656.53	135917784	128564701.84	10	196249132	1402	303	2913051299	9614030.69	41197715	44917637.45	23	108466239	1402	218	4119506	18896.82	609427	862243.99	2	1696687	13	861902907:594559867:594475490:862113035	40.82	1174049342	303	2913051299	9614030.69	218	85
GCA_020740605.1	mLemCat1	Lemur catta	185	2245601549	12138386.75	102162704	114059649.07	9	286674946	4724	395	2241959928	5675847.92	32529614	39535775.17	20	102401977	2355	210	3641621	17341.05	619577	675924.33	2	1306198	13	657410202:463387061:463910115:657252550	41.36	725797010	395	2241959928	5675847.92	210	185
GCA_027409185.1	mCynVol1	Cynocephalus volans	131	2814434834	21484235.37	165781880	165501677.98	7	304471933	16714	247	2814402334	11394341.43	69195939	84556919.30	12	229428798	16714	116	32500	280.17	200	343.08	35	500	200	840956119:566233776:566313867:840898572	40.24	1012723109	247	2814402334	11394341.43	116	131
GCA_028451465.1	mEreDor1	Erethizon dorsatum	116	2432147792	20966791.31	127995937	128012572.30	9	168646601	16828	393	2432078928	6188496.00	19239546	25655281.11	35	70129818	19	277	68864	248.61	380	339.53	70	500	10	716666559:498902583:498985218:717524568	41.03	811575751	393	2432078928	6188496.00	277	116
GCA_048771875.1	mCteGun2	Ctenodactylus gundi	535	2184404205	4082998.51	108787391	112938388.25	8	209091037	7689	652	2184385005	3350283.75	38834406	41132391.27	20	100330347	7689	117	19200	164.10	200	178.13	48	200	100	630182330:462532037:460978412:630692226	42.28	657130169	652	2184385005	3350283.75	117	535
GCA_963383645.1	mMusAve1	Muscardinus avellanarius	213	2497520702	11725449.31	119481734	133749910.03	8	239886027	1000	2018	2497159702	1237442.87	2432660	3087843.73	310	14310204	1000	1805	361000	200.00	200	200.00	903	200	200	727356951:521160388:520992196:727650167	41.73	1084122129	2018	2497159702	1237442.87	1805	213
GCA_902686455.2	mSciVul1.2	Sciurus vulgaris	639	2878607543	4504863.13	153872958	141946956.57	8	213194295	659	1816	2715248549	1495180.92	16327774	19062977.29	51	60449636	1	1177	163358994	138792.69	1022362	1376509.66	46	4737758	1	813947325:544157396:544103622:813040206	40.08	892482356	1816	2715248549	1495180.92	1177	639
GCA_902686445.2	mSciCar1	Sciurus carolinensis 	753	2815413801	3738929.35	148229995	134091414.86	8	208993527	10389	2577	2814809270	1092281.44	13975867	19131161.08	52	70386473	3804	1824	604531	331.43	500	438.09	605	500	28	843259201:563724980:564004408:843820681	40.06	939818722	2577	2814809270	1092281.44	1824	753
GCA_045843805.1	mUroPar1	Urocitellus parryii	2530	2935792869	1160392.44	184159334	161354800.25	7	284260672	10397	3224	2935664969	910566.06	23164455	29147716.89	33	87266425	1792	694	127900	184.29	200	191.48	320	200	100	879402403:588666197:587998024:879598345	40.08	959714283	3224	2935664969	910566.06	694	2530
GCA_964194105.1	mSpeCit3	Spermophilus citellus	498	3090049053	6204917.78	155990855	168060940.81	8	288966967	979	1934	3089761853	1597601.79	3445081	4094118.47	279	19865118	979	1436	287200	200.00	200	200.00	718	200	200	929732455:616820718:615876112:927332568	39.90	1271756052	1934	3089761853	1597601.79	1436	498
GCA_048772815.1	mCalLat2	Callospermophilus lateralis	8087	4646974320	574622.77	94176142	85300541.82	16	225145741	7432	9535	4646690800	487329.92	6579271	16713919.95	118	86968152	1	1448	283520	195.80	200	197.91	709	200	20	1404777508:918589308:917791351:1405532633	39.52	2448822300	9535	4646690800	487329.92	1448	8087
GCA_047511675.1	mMarFla1	Marmota flaviventris	814	2704668329	3322688.36	136846803	136251300.28	8	220842399	16442	1144	2704612429	2364171.70	52587502	53288071.02	17	127601862	7636	330	55900	169.39	200	181.93	140	200	100	812909476:539402391:539738052:812562510	39.90	930574901	1144	2704612429	2364171.70	330	814
GCA_903995435.1	mAcoRus1	Acomys russatus	623	2301522284	3694257.28	66475698	73419776.33	14	125099172	1017	1503	2293568115	1525993.42	4450755	6059590.58	145	27155307	196	880	7954169	9038.83	475642	1276001.83	3	3000000	2	659136629:487558836:487512765:659359885	42.51	730736567	1503	2293568115	1525993.42	880	623
GCA_947179515.1	mApoSyl1	Apodemus sylvaticus	498	2889801511	5802814.28	120938251	124090376.94	9	211764336	1000	1627	2889575894	1776014.69	4449850	5262913.71	199	17563194	1000	1129	225617	199.84	200	199.99	565	200	17	849791264:595779590:595519084:848485956	41.23	1155108734	1627	2889575894	1776014.69	1129	498
GCA_011762505.3	mArvNil1	Arvicanthis niloticus	1596	2496777707	1564397.06	82689117	89579362.11	11	167116563	1194	3220	2476488180	769095.71	11143170	17335939.53	56	90553658	37	1624	20289527	12493.55	198499	274958.99	29	950309	13	726396926:512695382:512254463:725141409	41.39	801270027	3220	2476488180	769095.71	1624	1596
GCA_015227675.2	mRatNor1	Rattus norvegicus	176	2647915728	15044975.73	135012528	147888080.17	8	260522016	746	757	2626580772	3469723.61	29198295	34606890.10	27	89387437	136	581	21334956	36721.09	268310	283005.51	26	660122	10	761705547:551469780:551505978:761899467	41.99	934089778	757	2626580772	3469723.61	581	176
GCA_963924665.1	mMicMin1	Micromys minutus	894	2651787409	2966205.16	59776753	77954610.84	14	261318752	1000	2914	2651383409	909877.63	1835000	2319141.82	443	11254030	1000	2020	404000	200.00	200	200.00	1010	200	200	794055195:530313622:531492468:795522124	40.05	1112894562	2914	2651383409	909877.63	2020	894
GCA_949316315.1	mMusMuc1.1	Mus musculus	179	2770968735	15480272.26	132150484	136646819.79	9	200127270	7482	280	2770948535	9896244.77	39533248	44510140.77	23	123630810	7482	101	20200	200.00	200	200.00	51	200	200	803375476:576001686:570631380:820939993	41.38	1063686042	280	2770948535	9896244.77	101	179
GCA_964271855.1	mAcoMin1	Acomys minous	113	2350237540	20798562.30	122851966	119960172.03	9	187704340	11000	297	2350217440	7913190.03	29281624	35465138.15	23	112549200	11000	184	20100	109.24	100	116.92	84	200	100	671142074:503605594:503891573:671578199	42.87	786428778	297	2350217440	7913190.03	184	113
GCA_037038515.1	mMicPen1	Microtus pennsylvanicus	181	2369135991	13089149.12	125308425	118654857.85	8	223010037	14952	241	2369124991	9830394.15	47175454	56342738.46	16	145900345	14952	60	11000	183.33	200	190.91	28	200	100	682664095:501119792:502946716:682394388	42.38	801409864	241	2369124991	9830394.15	60	181
GCA_903995425.1	mOncTor1	Onychomys torridus	2949	2468394440	837027.62	112723509	112119611.71	9	180773261	212	5092	2442231814	479621.33	2276141	2896743.71	308	12732129	1	2143	26162626	12208.41	1259395	1574943.96	6	3073328	1	710440166:510434390:510619697:710737561	41.81	794060434	5092	2442231814	479621.33	2143	2949
GCA_903992535.2	mArvAmp1	Arvicola amphibius	215	2297766297	10687285.10	158924400	146545327.67	7	200529155	4314	1088	2291739337	2106378.07	5308170	6775318.65	127	28543228	819	873	6026960	6903.73	172746	194791.51	11	495436	3	662879544:482940703:483070538:662848552	42.15	732196540	1088	2291739337	2106378.07	873	215
GCA_950005125.1	mChiNiv1	Chionomys nivalis	161	2393406913	14865881.45	88844950	98950611.91	10	205897943	1000	358	2393367513	6685384.11	30960136	33429891.62	25	78579696	1000	197	39400	200.00	200	200.00	99	200	200	694834166:502410848:502276385:693846114	41.98	823260367	358	2393367513	6685384.11	197	161
GCA_026229955.1	mPerMan1	Peromyscus maniculatus	1838	2847741276	1549369.57	43824230	48146898.67	21	129284778	8082	2082	2847716876	1367779.48	10714300	12890723.98	81	53767646	8082	244	24400	100.00	100	100.00	122	100	100	823318775:600701160:600715262:822981679	42.19	1066123143	2082	2847716876	1367779.48	244	1838
GCA_020740685.1	mJacJac1	Jaculus jaculus	159	2863848715	18011627.14	158244790	161570934.70	7	344072713	724	720	2850145935	3958536.02	21929955	25753642.18	40	76373269	210	561	13702780	24425.63	442193	620481.10	9	1608956	5	826385282:598418022:598602093:826740538	42.00	1248578025	720	2850145935	3958536.02	561	159
GCA_031878675.1	mThoBot2	Thomomys bottae	630	2025650949	3215318.97	64418693	61020005.29	12	106217240	11058	1405	2025496124	1441634.25	5921125	7357958.97	102	26541333	11058	775	154825	199.77	200	199.97	388	200	25	596678889:415326953:417509577:595980705	41.12	761219183	1405	2025496124	1441634.25	775	630
GCA_047511655.1	mCasCan1	Castor canadensis	502	2828089101	5633643.63	158968201	155045893.92	8	209551656	11452	683	2828052901	4140633.82	59379167	63485863.26	16	165525121	11452	181	36200	200.00	200	200.00	91	200	200	852294900:561533956:561650194:852573851	39.72	961316557	683	2828052901	4140633.82	181	502
GCA_964237555.1	mOryCun1	Oryctolagus cuniculus	222	2804674863	12633670.55	144279705	143354166.47	8	238208258	1000	2498	2804219663	1122585.93	2030165	2323410.71	443	8600074	1000	2276	455200	200.00	200	200.00	1138	200	200	785054236:617482504:616848069:784834854	44.02	1152434806	2498	2804219663	1122585.93	2276	222
GCA_030435755.1	mOchPri1	Ochotona princeps	5865	2555461757	435713.85	73962893	75926325.99	12	172484232	12751	6297	2555375528	405808.41	12191025	19391684.06	51	100297355	10343	432	86229	199.60	200	199.94	216	200	29	713683368:564356363:564036395:713299402	44.16	1077016097	6297	2555375528	405808.41	432	5865
GCA_026018925.1	mTupTan1	Tupaia tana	1198	2948294157	2461013.49	112954644	130056243.59	8	268061703	10403	2386	2948178402	1235615.42	7301848	11235401.15	97	41554477	319	1188	115755	97.44	100	99.38	579	100	23	852090252:621991624:621228615:852867911	42.17	1344358623	2386	2948178402	1235615.42	1188	1198
GCA_008692025.1	mPhoSin1	Phocoena sinus	65	2371540524	36485238.83	115469292	121132410.46	8	185845356	1871	277	2363494873	8532472.47	20218762	23072512.09	39	62522136	1	212	8045651	37951.18	198989	238486.83	12	667314	1	692827804:488843401:488783890:693039778	41.36	830922204	277	2363494873	8532472.47	212	65
GCA_963924675.1	mPhoPho1	Phocoena phocoena	440	2512729496	5710748.85	110192646	114469828.14	9	187254698	1000	1406	2512536296	1787010.17	3726689	4420654.05	208	13511482	1000	966	193200	200.00	200	200.00	483	200	200	733043618:523960324:524281928:731250426	41.72	968247654	1406	2512536296	1787010.17	966	440
GCA_011762595.2	mTurTru1	Tursiops truncatus	362	2378522214	6570503.35	108430135	117426417.89	9	183742880	1017	1036	2372299698	2289864.57	9729386	12808330.93	72	58340646	583	674	6222516	9232.22	118587	174908.59	15	656608	11	694132417:491768690:491286725:695111866	41.44	826854216	1036	2372299698	2289864.57	674	362
GCA_039906515.1	mPseCra1	Pseudorca crassidens	439	2674608476	6092502.22	110095734	118361935.37	9	198744646	9247	562	2671810484	4754111.18	58817648	64948074.34	15	176753052	3280	123	2797992	22747.90	358020	414056.43	3	764827	13	774369488:562928234:561437108:773075654	42.08	1105950996	562	2671810484	4754111.18	123	439
GCA_964270905.1	mLagAcu1	Leucopleurus acutus	899	2676209414	2976873.65	109653882	115893451.48	9	203976112	660	1933	2676002614	1384377.97	3493168	4341689.00	231	17882273	660	1034	206800	200.00	200	200.00	517	200	200	771137602:563658566:565160740:776045706	42.18	1108392241	1933	2676002614	1384377.97	1034	899
GCA_937001465.1	mOrcOrc1	Orcinus orca	448	2647351467	5909266.67	114219206	122049299.43	9	212697510	15590	571	2647327031	4636299.53	45583382	58772783.95	16	136725247	15590	123	24436	198.67	200	199.76	62	200	36	770893453:554908477:554533593:766991508	41.91	1088774256	571	2647327031	4636299.53	123	448
GCA_949774975.1	mLagAlb1	Lagenorhynchus albirostris	410	2544835795	6206916.57	110721866	116749731.17	9	192538540	1000	1480	2544621795	1719339.05	3398034	3957787.45	237	14893832	1000	1070	214000	200.00	200	200.00	535	200	200	737573936:533626700:532945245:740475914	41.91	998309044	1480	2544621795	1719339.05	1070	410
GCA_963455315.2	mGloMel1	Globicephala melas	993	2651292441	2669982.32	105087932	107357506.07	10	188105751	1000	2077	2651075824	1276396.64	3290841	3999100.95	247	18209847	99	1084	216617	199.83	200	199.99	542	200	17	762011605:558718032:564699155:765647032	42.38	1100764124	2077	2651075824	1276396.64	1084	993
GCA_964374135.1	mGraGri1	Grampus griseus	1146	2667081928	2327296.62	107608252	107354836.60	10	183334296	420	2284	2666854328	1167624.49	3106000	3842460.17	258	23496024	420	1138	227600	200.00	200	200.00	569	200	200	766770675:560699827:565972054:773411772	42.25	1100238641	2284	2666854328	1167624.49	1138	1146
GCA_036417435.1	mIniGeo1	Inia geoffrensis	903	2749362370	3044698.08	117431308	123020564.89	9	191777932	3064	1187	2749306105	2316180.37	40892022	48932296.66	20	124503031	3064	284	56265	198.12	200	199.93	141	282	31	796755589:578295780:578314524:795940212	42.07	1158761136	1187	2749306105	2316180.37	284	903
GCA_949987515.2	mDelDel1.1	Delphinus delphis	631	2663533373	4221130.54	107080983	107039948.65	10	184867555	1000	1599	2663339942	1665628.48	3627551	4192119.46	235	22869391	1000	968	193431	199.83	200	199.97	484	200	31	774897639:561293959:558941522:768206822	42.06	1122980345	1599	2663339942	1665628.48	968	631
GCA_009873245.3	mBalMus1	Balaenoptera musculus	106	2374868944	22404424.00	110314666	120190116.97	9	184938300	610	992	2348931802	2367874.80	6274848	8796540.34	104	35833660	1	886	25937142	29274.43	120226	189626.89	51	791139	1	693584531:479836853:480369658:695140760	40.88	808818886	992	2348931802	2367874.80	886	106
GCA_951394435.1	mSteCoe1.1	Stenella coeruleoalba	638	2691423227	4218531.70	105253534	110061441.78	10	190167893	1000	1631	2691224796	1650045.86	3590204	4086065.06	240	13388302	1000	993	198431	199.83	200	199.97	497	200	31	780092002:568272157:567001565:775859072	42.18	1146532579	1631	2691224796	1650045.86	993	638
GCA_028021215.1	mEscRob2	Eschrichtius robustus	704	2982434994	4236413.34	126538682	117796030.89	10	200946153	12535	983	2982379194	3033956.45	39209000	49159227.45	20	135014000	12535	279	55800	200.00	200	200.00	140	200	200	867897547:623690829:621268726:869522092	41.74	1368467495	983	2982379194	3033956.45	279	704
GCA_028023285.1	mBalRic1	Balaenoptera ricei	774	2678442663	3460520.24	122071569	121937457.82	9	194239256	1000	1108	2675821169	2415001.06	36541936	45718703.05	20	107985902	1000	334	2621494	7848.78	329223	688516.66	2	1215926	13	782027422:555627111:553212541:784954095	41.44	1086042246	1108	2675821169	2415001.06	334	774
GCA_949987535.1	mBalAcu1.1	Balaenoptera acutorostrata	1375	2772901778	2016655.84	116513105	114136791.20	10	198663870	1000	2552	2772666378	1086468.02	3015723	3601509.56	275	13478115	1000	1177	235400	200.00	200	200.00	589	200	200	810527824:575669799:576433288:810035467	41.55	1168637510	2552	2772666378	1086468.02	1177	1375
GCA_041834305.1	mMegNov1	Megaptera novaeangliae	1355	3146604256	2322217.16	107416641	99657233.66	12	191558633	7800	1443	3146595456	2180592.83	36344089	40641332.52	26	124171542	7800	88	8800	100.00	100	100.00	44	100	100	910967740:660345150:662780947:912501619	42.05	1503424902	1443	3146595456	2180592.83	88	1355
GCA_965194825.1	mBalPhy1	Balaenoptera physalus	2612	3442554901	1317976.61	110866263	97741990.57	12	197289168	1000	4128	3442251701	833878.80	2079521	2731789.83	460	10833546	1000	1516	303200	200.00	200	200.00	758	200	200	1004283341:730170367:722136955:985661038	42.19	1787346769	4128	3442251701	833878.80	1516	2612
GCA_965194805.1	mBalBor1	Balaenoptera borealis	2572	3234573494	1257610.22	118917181	103150343.89	11	194562506	1000	3751	3234337694	862260.12	2585625	3362505.31	344	14088461	1000	1179	235800	200.00	200	200.00	590	200	200	945648472:680288676:677947594:930452952	41.99	1617252137	3751	3234337694	862260.12	1179	2572
GCA_025265405.1	mMesDen1	Mesoplodon densirostris	73	2683375131	36758563.44	125805690	133752927.95	8	247284360	49122	170	2682674828	15780440.16	48253041	56351657.44	18	131637648	15449	97	700303	7219.62	126210	178413.02	2	315505	13	781542908:555878398:562891776:782361746	41.70	1107045066	170	2682674828	15780440.16	97	73
GCA_964165515.1	mMesBid2	Mesoplodon bidens	1602	2999098505	1872096.45	107252728	108285629.88	10	230086563	1000	2697	2998879505	1111931.59	3140665	3833448.69	284	18454384	1000	1095	219000	200.00	200	200.00	548	200	200	869454852:632279525:628569975:868575153	42.04	1339695410	2697	2998879505	1111931.59	1095	1602
GCA_964341445.1	mMesMir1	Mesoplodon mirus	2757	3442419404	1248610.59	115717908	115944179.76	10	232780520	1000	3997	3442171388	861188.74	3298322	3914948.28	310	12959638	1000	1240	248016	200.01	200	200.01	620	216	200	990299120:727313733:734982911:989575624	42.48	1754480595	3997	3442171388	861188.74	1240	2757
GCA_949752795.1	mHypAmp2.1	Hyperoodon ampullatus	757	2828760712	3736804.11	117448692	118082210.20	9	230449670	1000	1855	2828541112	1524820.01	3126546	3942371.47	266	19981646	1000	1098	219600	200.00	200	200.00	549	200	200	824417814:591661210:590895558:821566530	41.81	1253775112	1855	2828541112	1524820.01	1098	757
GCA_026419965.1	mKogBre1	Kogia breviceps	580	2555838840	4406618.69	122394096	131830115.46	8	202422507	9545	723	2551041071	3528410.89	42780423	53737923.73	20	201991588	9545	143	4797769	33550.83	4376142	3997661.02	1	4376142	13	736991690:534836360:537830706:741382315	42.05	1007980803	723	2551041071	3528410.89	143	580
GCA_028564815.2	mEubGla1	Eubalaena glacialis	788	2843675187	3608724.86	129620717	134431593.29	9	240837649	12339	1155	2838717103	2457763.73	37467374	40379677.86	25	101487703	12339	367	4958084	13509.77	3661394	2727325.09	1	3661394	13	828341043:592562256:590878899:826934905	41.69	1234443559	1155	2838717103	2457763.73	367	788
GCA_005190385.3	mMonMon1	Monodon monocero	101	2341954608	23187669.39	108465051	118235360.03	9	182208776	397	414	2341923308	5656819.58	22031227	25393866.32	36	83581340	397	313	31300	100.00	100	100.00	157	100	100	687616539:482917370:483365537:688023862	41.26	808010906	414	2341923308	5656819.58	313	101
GCA_030028045.1	mHipAmp2	Hippopotamus amphibius	356	2538242855	7129895.66	149218186	157163419.59	7	240032215	21224	582	2538197655	4361164.36	50348260	50471467.74	18	105926430	21224	226	45200	200.00	200	200.00	113	200	200	741287594:527870411:527990551:741049099	41.60	886195041	582	2538197655	4361164.36	226	356
GCA_042477335.2	mOviCan1	Ovis canadensis	41	2974267070	72543099.27	105224494	138432190.21	9	281219098	26564	44	2974266770	67596972.05	105224494	136310824.46	9	281219098	26564	3	300	100.00	100	100.00	2	100	100	830264505:650503259:655384190:838114816	43.91	1379024006	44	2974266770	67596972.05	3	41
GCA_040805955.1	mOviAri1	Ovis aries	28	2853626077	101915217.04	103395564	138194563.15	9	287792376	26593495	28	2853626077	101915217.04	103395564	138194563.15	9	287792376	26593495	0	0	0.00	0	0.00	0	0	0	809364347:615378585:616524462:812358683	43.17	1239637807	28	2853626077	101915217.04	0	28
GCA_003369695.2	UOA_Brahman_1	Bos taurus	1251	2680969395	2143061.07	104466507	96623257.31	11	156943404	1040	1553	2679332898	1725262.65	26764281	31013525.17	32	79234837	1040	302	1636497	5418.86	307936	267027.89	3	396419	13	779589770:560432193:560306545:779004390	41.83	1090759921	1553	2679332898	1725262.65	302	1251
GCA_041735815.1	mCapHir4	Capra hircus	31	2863923675	92384634.68	100793790	104589180.17	12	166528736	20906000	31	2863923675	92384634.68	100793790	104589180.17	12	166528736	20906000	0	0	0.00	0	0.00	0	0	0	810638146:617548874:619384222:816352433	43.19	1250026247	31	2863923675	92384634.68	0	31
GCA_910594005.1	mCerEla1	Cervus elaphus	145	2886619877	19907723.29	83473711	89239891.34	13	179953079	16353	185	2886609477	15603294.47	68741660	65507991.01	17	114897605	16353	40	10400	260.00	200	315.38	14	500	200	819723673:619711663:620941528:826232613	42.98	1271094356	185	2886609477	15603294.47	40	145
GCA_963930625.1	mMunRee1	Muntiacus reevesi	268	2656184892	9911137.66	114544513	151457157.80	7	285828854	1000	950	2656048492	2795840.52	5780196	6976994.04	142	28506795	1000	682	136400	200.00	200	200.00	341	200	200	770884029:555900653:556791026:772472784	41.89	1044427343	950	2656048492	2795840.52	682	268
GCA_048126745.1	mDamDam1	Dama dama	1304	2723325442	2088439.76	76496593	78163014.88	14	146771910	1000	1451	2723310742	1876850.96	49431082	50438629.28	20	102731773	300	147	14700	100.00	100	100.00	74	100	100	793193123:567836701:570424732:791856186	41.80	1108825481	1451	2723310742	1876850.96	147	1304
GCA_048338725.1	mSusScr2	Sus scrofa	20	2633166191	131658309.55	144930921	156255536.59	8	293184154	43245276	20	2633166191	131658309.55	144930921	156255536.59	8	293184154	43245276	0	0	0.00	0	0.00	0	0	0	757429082:560772317:559698457:755266335	42.55	984911871	20	2633166191	131658309.55	0	20
GCA_036321535.1	mCamDro1	Camelus dromedarius	172	2306619778	13410580.10	72991593	69917291.65	12	123284173	16684	367	2306580778	6284961.25	31216184	36196900.21	22	114989628	16684	195	39000	200.00	200	200.00	98	200	200	672301071:479921310:480457099:673901298	41.64	760559355	367	2306580778	6284961.25	195	172
GCA_036426135.1	mEquCab1	Equus caballus	602	2596737506	4313517.45	90406661	92461335.00	12	192293490	12888	716	2596714706	3626696.52	43557573	45879876.35	21	92504942	12888	114	22800	200.00	200	200.00	57	200	200	751523710:546474873:546315987:752400136	42.08	841002756	716	2596714706	3626696.52	114	602
GCA_020826845.1	mDicBic1	Diceros bicornis minor	1075	3005519209	2795831.82	65026825	64736838.90	17	139927959	4838	1290	3004150348	2328798.72	28468213	34296983.82	31	94307620	2118	215	1368861	6366.80	268362	277164.76	2	519385	13	877533753:625261448:624197206:877157941	41.59	1188217428	1290	3004150348	2328798.72	215	1075
GCA_031878705.1	mTapInd1	Tapirus indicus	193	2477445429	12836504.81	129754520	114579177.02	9	171925268	16747	285	2477427029	8692726.42	56553937	61094853.54	15	154784349	16747	92	18400	200.00	200	200.00	46	200	200	728816322:509806687:509975465:728828555	41.16	751167686	285	2477427029	8692726.42	92	193
GCA_004126475.3	mPhyDis1	Phyllostomus discolor	78	2108849533	27036532.47	171742863	158537427.76	6	218430143	16692	962	2093760677	2176466.40	6892556	8009588.48	94	24911458	1	884	15088856	17068.84	86812	172738.69	38	752955	1	603007106:443642975:443678180:603432416	42.38	632782137	962	2093760677	2176466.40	884	78
GCA_038363095.2	mArtLit1	Artibeus lituratus	487	2311617438	4746647.72	160301290	154316646.12	6	245578882	10282	532	2311610138	4345131.84	65515378	83669351.92	11	193238238	10282	45	7300	162.22	200	176.71	19	200	100	665094684:491404698:489869307:665241449	42.45	789283627	532	2311610138	4345131.84	45	487
GCA_038363145.1	mArtInt1	Artibeus intermedius	419	2293600955	5473987.96	160430197	158071934.11	6	245407277	11386	500	2293588855	4587177.71	60026580	63662101.50	14	144957903	8482	81	12100	149.38	200	166.12	31	200	100	661827433:484967054:484802230:661992138	42.28	777922033	500	2293588855	4587177.71	81	419
GCA_039655065.1	mGloMut1	Glossophaga mutica	82	2159908085	26340342.50	169732090	164309583.82	6	228375179	1874	129	2159899785	16743409.19	77027013	99295076.61	8	219477644	1874	47	8300	176.60	200	186.75	21	200	100	624685401:455816715:455400707:623996962	42.19	700221272	129	2159899785	16743409.19	47	82
GCA_022682495.2	mDesRot1	Desmodus rotundus	573	2119704833	3699310.35	160127860	150948553.37	6	212258161	2263	1188	2119447770	1784046.94	6739964	9025476.74	87	34694016	2031	615	257063	417.99	500	452.91	258	500	240	603737590:455468047:455689716:604552417	42.99	680824813	1188	2119447770	1784046.94	615	573
GCA_037157525.1	mMolAlv2	Molossus alvarezi 	326	2478684717	7603327.35	112651663	121526232.25	9	278819313	6205	406	2478672017	6105103.49	63410948	62935424.26	15	142808176	6205	80	12700	158.75	200	174.02	32	200	100	715178319:524339292:524045224:715109182	42.30	993706447	406	2478672017	6105103.49	80	326
GCA_014108415.1	mMolMol1	Molossus molossus	61	2315585093	37960411.36	110665204	116870739.52	9	252436072	16612	410	2268212219	5532224.92	22174888	28048056.69	30	77248698	16612	349	47372874	135738.89	536154	738647.80	24	2208597	13	653607545:480312161:480234207:654058306	42.35	845782122	410	2268212219	5532224.92	349	61
GCA_039880945.1	mMolNig1	Molossus nigricans	366	2567103348	7013943.57	114338547	121500021.43	9	290657952	4125	479	2567086048	5359261.06	74731956	66675531.64	14	136289148	4125	113	17300	153.10	200	169.36	44	200	100	735855425:546780670:546911004:737538949	42.60	1052737677	479	2567086048	5359261.06	113	366
GCA_030848825.1	mTadBra1	Tadarida brasiliensis	148	2283188801	15426951.36	111098925	113472843.45	9	250357659	2116	168	2283182849	13590374.10	86333355	80897063.62	11	131629194	2116	20	5952	297.60	493	364.56	6	500	89	658763129:482554093:482927368:658938259	42.29	812962846	168	2283182849	13590374.10	20	148
GCA_043748645.1	mMopCon1	Mops condylurus	38	2209024231	58132216.61	105478936	113863371.40	9	247113240	17159	126	2208984911	17531626.28	56964224	55998532.26	15	127910798	17159	88	39320	446.82	500	471.43	40	500	240	631023282:473509576:473830140:630621913	42.89	783147616	126	2208984911	17531626.28	88	38
GCA_014108235.1	mMyoMyo1	Myotis myotis	93	2002797876	21535461.03	94448911	123074500.75	7	223369599	15962	631	1973844471	3128121.19	12511134	16950214.48	41	52272724	3543	538	28953405	53816.74	203761	455091.66	32	2158065	13	561685908:425520911:425393252:561244400	43.11	705093877	631	1973844471	3128121.19	538	93
GCA_963259705.1	mMyoDau2	Myotis daubentonii	122	2127824474	17441184.21	102234773	130352320.56	7	234112155	1000	1221	2127604674	1742509.97	3062752	3651405.79	213	11998348	1000	1099	219800	200.00	200	200.00	550	200	200	603752525:459651294:459061417:605139438	43.18	812733551	1221	2127604674	1742509.97	1099	122
GCA_964094495.2	mMyoMys1	Myotis mystacinus	526	2081199042	3956652.17	99827109	125724943.49	7	232649590	1000	2092	2080885842	994687.30	2201046	2828212.20	273	9892288	1000	1566	313200	200.00	200	200.00	783	200	200	593604841:447626113:447029788:592625100	42.99	769342057	2092	2080885842	994687.30	1566	526
GCA_964212035.2	mMyoNat1	Myotis nattereri	212	2138592721	10087701.51	99996439	128759173.83	7	231240774	1000	437	2138547721	4893701.88	44226636	43937855.94	17	93175039	1000	225	45000	200.00	200	200.00	113	200	200	607228796:461415124:461435788:608468013	43.15	812066094	437	2138547721	4893701.88	225	212
GCA_965115925.1	mMyoEma1	Myotis emarginatus	402	2109797427	5248252.31	96276321	123164935.82	7	229996673	1000	1942	2109489427	1086245.84	2127843	2584811.55	301	11061870	1000	1540	308000	200.00	200	200.00	770	200	200	606278210:448769589:448836761:605604867	42.55	816662431	1942	2109489427	1086245.84	1540	402
GCA_014108245.1	mPipKuh1	Pipistrellus kuhlii	203	1775705730	8747318.87	80237350	95318578.95	7	197205563	17189	597	1763504239	2953943.45	10591995	14970355.27	43	51030577	17189	394	12201491	30968.25	179538	225322.15	22	823211	13	506432908:375457696:375351633:506262002	42.57	599932165	597	1763504239	2953943.45	394	203
GCA_903992545.1	mPipPip1	Pipistrellus pipistrellus	323	1763439233	5459564.19	94929986	112908310.36	6	203623556	11953	1869	1762969866	943269.06	4446752	5910234.67	108	27664949	2621	1546	469367	303.60	500	416.21	470	501	2	506489804:375063522:375078565:506337975	42.55	598982714	1869	1762969866	943269.06	1546	323
GCA_949987585.1	mPipPyg2.1	Pipistrellus pygmaeus	243	1895125685	7798871.13	89507134	114563616.44	7	212679785	1000	404	1895093668	4690825.91	54047000	49904936.04	14	101953362	1000	161	32017	198.86	200	199.90	81	200	17	543461957:404470433:404157598:543003680	42.67	700624707	404	1895093668	4690825.91	161	243
GCA_964656225.1	mPipNat1	Pipistrellus nathusii	1062	1916223105	1804353.21	90095264	110884657.07	7	212136723	1000	2898	1915855905	661095.90	1635117	1994815.64	352	8873984	1000	1836	367200	200.00	200	200.00	918	200	200	554244402:405732050:403826471:552052982	42.26	714868824	2898	1915855905	661095.90	1836	1062
GCA_964339955.1	mPipHan1	Pipistrellus hanaki	141	1892221984	13420014.07	89115682	113799183.42	7	210776044	11000	447	1892187884	4233082.51	48700701	42217536.98	16	90287000	1769	306	34100	111.44	100	120.53	136	200	100	544367315:402203094:402882170:542735305	42.55	713041538	447	1892187884	4233082.51	306	141
GCA_951640355.1	mEptNil1.1	Cnephaeus nilssonii 	207	2064119045	9971589.59	98018206	91875483.98	10	133114493	2000	1630	2063834445	1266156.10	2474537	3027059.43	256	11576827	2000	1423	284600	200.00	200	200.00	712	200	200	585120304:446797596:447340426:584576119	43.32	771611635	1630	2063834445	1266156.10	1423	207
GCA_027574615.1	mEptFus1	Eptesicus fuscus	49	2008074896	40981120.33	102817582	93258259.53	9	136610247	17030	124	2008046339	16193922.09	49033427	55539696.31	13	108338125	17030	75	28557	380.76	498	425.57	29	504	84	566832292:436848817:436900314:567464916	43.51	730704253	124	2008046339	16193922.09	75	49
GCA_963455305.1	mPleAur1	Plecotus auritus	65	2163221563	33280331.74	186501726	180702018.67	5	248793850	1000	1302	2162974122	1661270.45	2948753	3591311.80	226	14172224	1000	1237	247441	200.03	200	200.04	619	214	200	615281319:465428947:466277011:615986845	43.08	843851222	1302	2162974122	1661270.45	1237	65
GCA_037038545.1	mRhyNas2	Rhynchonycteris naso	41	2455066473	59879670.07	286991050	255389342.12	4	372384904	16628	109	2455055873	22523448.38	86271459	99862407.87	10	209121287	3412	68	10600	155.88	200	171.70	27	200	100	727106934:500342997:500785752:726820190	40.78	1004816638	109	2455055873	22523448.38	68	41
GCA_027563665.1	mAntPal1	Antrozous pallidus	93	2126460045	22865161.77	114648712	112918401.75	8	213208487	6026	327	2120575367	6484939.96	41887785	43901960.44	17	91428339	1	234	5884678	25148.20	164401	243278.00	10	758021	1	604181869:456396325:456225750:603771423	43.04	822482615	327	2120575367	6484939.96	234	93
GCA_026230055.1	mCorTow1	Corynorhinus townsendii	391	2104912948	5383409.07	174690156	170484720.74	6	233461832	11533	610	2104891048	3450641.06	23382908	25511732.66	30	70937382	11533	219	21900	100.00	100	100.00	110	100	100	601903767:450550033:450532251:601904997	42.81	775728136	610	2104891048	3450641.06	219	391
GCA_963924515.1	mVesMur1	Vespertilio murinus	178	1925577803	10817852.83	186292382	144782491.66	5	219009580	1000	1158	1925381803	1662678.59	3319810	3992159.52	177	15400909	1000	980	196000	200.00	200	200.00	490	200	200	543460164:419073798:419330746:543517095	43.54	706126819	1158	1925381803	1662678.59	980	178
GCA_964264875.2	mNycLei1	Nyctalus leisleri	585	2226338041	3805706.05	95320580	111526913.02	8	231334465	1000	887	2226277641	2509895.87	26125689	31343797.95	23	75910365	1000	302	60400	200.00	200	200.00	151	200	200	634474516:479530179:478653712:633619234	43.04	927261733	887	2226277641	2509895.87	302	585
GCA_964146895.2	mMinSch1	Miniopterus schreibersii	186	1850590334	9949410.40	87795433	100270149.34	8	202313579	13000	326	1850562334	5676571.58	28014000	32192266.13	21	83366000	13000	140	28000	200.00	200	200.00	70	200	200	531929421:392159448:394474866:531998599	42.51	562459587	326	1850562334	5676571.58	140	186
GCA_036850995.1	mSacLep1	Saccopteryx leptura	167	2576497192	15428126.90	224759591	253588801.23	4	392736510	938	740	2556882759	3455246.97	17812205	22923237.00	41	75203878	1	573	19614433	34231.12	387202	488753.52	14	1217975	1	743597696:534879543:535029512:743376008	41.84	1074984203	740	2556882759	3455246.97	573	167
GCA_036850765.1	mSacBil1	Saccopteryx bilineata	257	2612326447	10164694.35	300074216	268066483.65	4	408423836	885	725	2579234402	3557564.69	20047694	23388185.63	39	67663810	1	468	33092045	70709.50	711330	938985.43	13	2467699	1	751824455:537877112:537880465:751652370	41.71	1116902591	725	2579234402	3557564.69	468	257
GCA_004115265.3	mRhiFer1	Rhinolophus ferrumequinum	135	2075785400	15376188.15	88025743	80523079.50	11	124933378	16838	293	2068239302	7058837.21	29908815	32899579.09	23	97569473	1	158	7546098	47760.11	289838	363834.03	7	833261	1	615054589:419203225:419230284:614751204	40.54	599547966	293	2068239302	7058837.21	158	135
GCA_964194185.1	mRhiHip2	Rhinolophus hipposideros	723	2171328640	3003220.80	88364482	81458100.95	11	127722468	1000	2350	2171003240	923831.17	2014157	2440157.72	336	12290712	1000	1627	325400	200.00	200	200.00	814	200	200	641656522:440946693:445063742:643336283	40.81	689692849	2350	2171003240	923831.17	1627	723
GCA_043728145.1	mRhiTri1	Rhinolophus trifoliatus	126	2232422560	17717639.37	184920896	153549886.39	6	220842049	14106	523	2232259940	4268183.44	11115074	15643304.65	54	55373560	14106	397	162620	409.62	500	447.05	163	500	240	662318685:453337520:454252734:662351001	40.66	732564932	523	2232259940	4268183.44	397	126
GCA_043880425.1	mRhiYon1	Rhinolophus yonghoiseni	1486	2323192134	1563386.36	181652838	160958335.80	6	257792783	2048	1682	2323115974	1381162.89	28095277	32812094.83	26	99922004	2048	196	76160	388.57	500	431.18	77	500	240	677578251:485369988:484005167:676162568	41.73	830808761	1682	2323115974	1381162.89	196	1486
GCA_043728065.1	mRhiAff1	Rhinolophus affinis	2194	2302456897	1049433.41	85365043	75590628.95	12	121013437	16962	2231	2302442557	1032022.66	65534120	55814198.11	14	110858912	16962	37	14340	387.57	500	430.38	15	500	240	674872239:478464315:474848100:674257903	41.40	806537852	2231	2302442557	1032022.66	37	2194
GCA_043748575.1	mRhiPer1	Rhinolophus perniger lanosus	66	2185535924	33114180.67	154900566	156591971.34	6	232970026	12249	129	2185514824	16941975.38	53323821	55726838.30	15	113602117	12249	63	21100	334.92	500	381.71	22	500	240	647115735:443485230:446526776:648387083	40.72	690464147	129	2185514824	16941975.38	63	66
GCA_014176215.1	mRouAeg1	Rousettus aegyptiacus	30	1893618717	63120623.90	113811795	124101239.57	7	185846147	16645	272	1866944222	6863765.52	21999313	27744097.49	25	80973667	16645	242	26674495	110225.19	386342	685594.01	16	2159662	13	559878735:373930060:373689283:559446144	40.05	491035753	272	1866944222	6863765.52	242	30
GCA_031876335.1	mHipLar1	Hipposideros larvatus	69	2338923724	33897445.28	185549907	159907928.55	6	231003163	1619	188	2338890320	12440905.96	34562834	38504197.01	23	94634578	217	119	33404	280.71	500	355.94	34	500	13	683188980:482464911:489247698:683988731	41.55	816532962	188	2338890320	12440905.96	119	69
GCA_043880285.1	mDorCyc1	Doryrhina cyclops	66	2390604663	36221282.77	154073572	166510416.15	6	238799895	5170	400	2390465483	5976163.71	14255823	17536875.68	49	55627024	5170	334	139180	416.71	500	452.03	140	500	240	698398934:496474911:496973170:698618468	41.56	852733902	400	2390465483	5976163.71	334	66
GCA_043727835.1	mAseSto1	Aselliscus stoliczkanus	75	2268696503	30249286.71	162130651	157449005.15	7	211037740	16750	162	2268667635	14004121.20	61181192	61619066.98	14	106140467	1	87	28868	331.82	500	387.75	29	500	40	666029896:468742196:468730320:665165223	41.32	747897776	162	2268667635	14004121.20	87	75
GCA_043880545.1	mRhiMic1	Rhinopoma microphyllum	106	2564586454	24194211.83	146810189	141987624.05	7	247261581	15268	258	2564523392	9940013.15	32895649	36794876.29	25	89025634	15268	152	63062	414.88	500	452.20	64	500	42	737411280:543999670:545014486:738097956	42.46	1040712762	258	2564523392	9940013.15	152	106
GCA_043880595.1	mMegSpa1	Megaderma spasma	419	2124740378	5070979.42	120949103	130170704.69	7	244117117	2177	1285	2080266234	1618884.23	22627155	25679021.72	28	73915687	4	866	44474144	51355.82	318869	378605.17	46	1495257	1	604853527:435807793:435341238:604263676	41.88	636038425	1285	2080266234	1618884.23	866	419
GCA_902655055.2	mLutLut1	Lutra lutra	44	2438458878	55419519.95	149004807	149463114.45	7	223449203	15217	229	2438368607	10647897.85	30403456	38225509.15	23	97449666	15217	185	90271	487.95	500	495.80	91	500	33	711516459:506984798:507228881:712638469	41.59	824666273	229	2438368607	10647897.85	185	44
GCA_009829155.1	mMusErm1	Mustela erminea	94	2445217281	26012949.80	130149454	127565170.20	8	220353689	1292	293	2423733305	8272127.32	36329944	48508854.70	19	150520205	785	199	21483976	107959.68	370179	763455.73	15	3113081	13	708049663:503598798:503819444:708265400	41.56	803373986	293	2423733305	8272127.32	199	94
GCA_030435805.1	mMusLut2	Mustela lutreola	26	2586285479	99472518.42	154078643	165290537.45	7	290104894	16552	65	2586277679	39788887.37	83356672	90759971.64	11	171611272	16552	39	7800	200.00	200	200.00	20	200	200	752023851:541577946:540764239:751911643	41.85	931263626	65	2586277679	39788887.37	39	26
GCA_964662115.1	mMusNiv2	Mustela nivalis vulgaris	3180	3437873602	1081092.33	115392379	100849903.87	11	215721019	1000	6118	3437285986	561831.64	1161649	1459165.56	874	6318960	1000	2938	587616	200.01	200	200.01	1469	216	200	970991594:749875683:746719790:969698919	43.54	1687695579	6118	3437285986	561831.64	2938	3180
GCA_964106545.1	mNeoVis2	Neogale vison	435	2697147479	6200339.03	221119109	203744413.84	6	325660011	1000	3392	2696556079	794975.26	1439238	1784770.83	568	8136319	1000	2957	591400	200.00	200	200.00	1479	200	200	776993560:571140182:571969167:776453170	42.39	1013068347	3392	2696556079	794975.26	2957	435
GCA_963455335.1	mMarMar1	Martes martes	477	2484650161	5208910.19	146289188	143543651.74	7	217416870	1000	2727	2484200161	910964.49	1599794	1861628.45	493	8401958	1000	2250	450000	200.00	200	200.00	1125	200	200	716216450:526053600:526766153:715163958	42.38	848812639	2727	2484200161	910964.49	2250	477
GCA_922984935.2	mMelMel1	Meles meles	538	2738694574	5090510.36	132955750	128316900.86	8	216965501	16570	639	2738670774	4285869.76	75210923	80733866.81	12	210729441	16570	101	23800	235.64	200	275.63	42	500	200	788220353:581848078:581588395:787013948	42.48	1027353557	639	2738670774	4285869.76	101	538
GCA_905319855.2	mCanLor1	Canis lupus orion	82	2447463909	29847120.84	65778685	69157978.76	15	124665963	16690	248	2447418109	9868621.41	34375412	35140027.02	25	81873012	16690	166	45800	275.90	500	418.78	46	500	100	716373599:508081016:507378076:715585418	41.49	833869944	248	2447418109	9868621.41	166	82
GCA_011100685.1	mCanFam4	Canis lupus familiaris	2198	2482000080	1129208.41	64299765	65728117.55	15	124992030	13084	2783	2481941580	891822.34	14840767	16125395.85	57	56930620	13084	585	58500	100.00	100	100.00	293	100	100	725519965:515050823:514961767:726409025	41.50	834164823	2783	2481941580	891822.34	585	2198
GCA_048164855.1	mCanLup2	Canis lupus baileyi	250	2495606587	9982426.35	65569260	69017026.44	15	125236116	4299	417	2495576687	5984596.37	31962680	32169896.58	28	93831034	4299	167	29900	179.04	200	188.29	75	200	100	729286792:519007036:518145069:729137790	41.56	857679421	417	2495576687	5984596.37	167	250
GCA_964106825.2	mVulVul1	Vulpes vulpes	461	2411727275	5231512.53	139235879	141597924.94	8	200869998	2000	2306	2411358275	1045688.76	2040520	2429818.08	373	10967384	2000	1845	369000	200.00	200	200.00	923	200	200	707472983:498329145:498469695:707086452	41.34	776394283	2306	2411358275	1045688.76	1845	461
GCA_040955705.1	mLycPic1	Lycaon pictus	76	2384012108	31368580.37	64477381	69275046.69	14	125541836	1000	167	2384003008	14275467.11	39426608	42841293.63	21	118147063	1000	91	9100	100.00	100	100.00	46	100	100	698960023:492297429:492211355:700534201	41.30	787642211	167	2384003008	14275467.11	91	76
GCA_009762305.2	mZalCal1	Zalophus californianus	47	2409685310	51269900.21	147124152	148471913.99	7	216121386	6074	232	2391147534	10306670.41	31618759	36884994.79	24	88945600	382	185	18537776	100204.19	770694	675946.21	10	1132708	5	700647353:494989984:494836143:700674054	41.40	800288063	232	2391147534	10306670.41	185	47
GCA_964656455.1	mHalGry1	Halichoerus grypus	171	2400078677	14035547.82	156124300	162587921.66	7	216553034	13020	1301	2399852677	1844621.58	3750431	4455163.74	198	16884657	13020	1130	226000	200.00	200	200.00	565	200	200	701844249:498812160:498645424:700550844	41.56	809833826	1301	2399852677	1844621.58	1130	171
GCA_007474595.2	mLynCan1	Lynx canadensis	55	2407827299	43778678.16	147275701	150205022.78	7	240012660	17044	897	2405047953	2681212.88	7503561	9449521.31	94	34360538	20	842	2779346	3300.89	84440	152393.84	8	378177	1	700409006:501192096:501753800:701693051	41.70	810347934	897	2405047953	2681212.88	842	55
GCA_028018385.1	mNeoNeb1	Neofelis nebulosa	34	2468361932	72598880.35	150204169	151529177.04	7	243997075	16839	215	2466998080	11474409.67	51579577	56951881.14	16	151393616	16839	181	1363852	7535.09	95575	177140.42	3	327273	13	717746672:515348575:515660079:718242754	41.79	834068756	215	2466998080	11474409.67	181	34
GCA_046562885.1	mPanOnc1	Panthera onca	115	2303345105	20029087.87	148304554	150938718.84	7	241924008	15670	255	2303317105	9032616.10	45599555	56303178.29	16	180867076	15670	140	28000	200.00	200	200.00	70	200	200	671997522:479743022:479852637:671723924	41.66	758678373	255	2303317105	9032616.10	140	115
GCA_030020395.1	mManPen7	Manis pentadactyla	662	2840181150	4290303.85	149551276	150668813.44	8	237121291	7494	1045	2833618130	2711596.30	25547713	41768625.88	27	152504290	7494	383	6563020	17135.82	1137493	1028605.35	2	2228952	13	834702290:583484831:580409541:835021468	41.07	1092871065	1045	2833618130	2711596.30	383	662
GCA_024139225.1	mSunEtr1	Suncus etruscus	148	2471683639	16700565.13	131952995	130872588.55	8	208244741	2499	1158	2461039567	2125250.06	5042816	7348256.62	133	28387302	152	1010	10644072	10538.69	233732	321163.73	12	905386	1	740484722:489946878:489677322:740930645	39.81	1131165115	1158	2461039567	2125250.06	1010	148
GCA_027595985.1	mSorAra2	Sorex araneus	66	2406010873	36454710.20	374364821	289681800.60	3	452700413	9918	1493	2393066909	1602857.94	4024507	4866749.59	182	19703282	9918	1427	12943964	9070.75	302828	480105.32	9	1386908	13	679087110:517464447:517284515:679230837	43.24	982940389	1493	2393066909	1602857.94	1427	66
GCA_964194135.1	mTalEur1	Talpa europaea	464	2061000977	4441812.45	136888642	124547777.46	7	158759103	1000	1520	2060789777	1355782.75	3421604	4172908.71	183	17531302	1000	1056	211200	200.00	200	200.00	528	200	200	596354209:433639769:433615212:597180587	42.08	679613934	1520	2060789777	1355782.75	1056	464
GCA_950295315.1	mEriEur2.1	Erinaceus europaeus	1175	2720701264	2315490.44	126757761	124239036.71	9	210889723	1000	4935	2719949264	551154.87	999919	1227898.29	818	5852943	1000	3760	752000	200.00	200	200.00	1880	200	200	788681332:571176832:571247902:788843198	42.00	1463928689	4935	2719949264	551154.87	3760	1175
GCA_011100635.1	mTriVul1	Trichosurus vulpecula	212	3359347793	15845980.16	442560073	388198369.32	4	568656204	551	2008	3340651330	1663670.98	4314688	6059199.91	218	35916348	120	1796	18696463	10410.06	169642	281769.10	31	982440	7	1010059692:659436229:659516820:1011638589	39.48	1343610007	2008	3340651330	1663670.98	1796	212
GCA_028372415.2	mMacEug1	Macropus eugenii	273	3447481802	12628138.47	489668034	506400686.50	3	762225844	3187	788	3440931105	4366663.84	15255043	21215459.86	60	64234404	3187	515	6550697	12719.80	195680	204946.50	11	619111	13	1054554908:665922745:666655913:1053797539	38.73	1341669404	788	3440931105	4366663.84	515	273
GCA_003287225.2	phaCin_HiC	Phascolarctos cinereus	1246	3192631935	2562304.92	428240489	435983112.61	3	730425699	353	1915	3192565134	1667135.84	11399805	13575750.57	87	40558015	353	669	66801	99.85	100	100.00	335	100	1	972951161:623402338:623395108:972816527	39.05	1235179243	1915	3192565134	1667135.84	669	1246
GCA_037893015.1	mMacLag1	Macrotis lagotis	609	3655732635	6002845.05	343853051	513540259.60	3	934355481	17457	5040	3643208723	722858.87	1223998	1591981.77	869	6903487	14832	4431	12523912	2826.43	9380	9333.76	486	25872	1	1141187072:680386027:680506772:1141128852	37.35	1569468363	5040	3643208723	722858.87	4431	609
GCA_048593235.1	mSmiCra1	Sminthopsis crassicaudata	7	3239981553	462854507.57	656909261	579191568.20	3	757456671	89927176	1915	3239677604	1691737.65	4228802	7104916.60	189	43543530	6820	1908	303949	159.30	529	858.94	129	2783	1	1034577737:585139649:585143197:1034817021	36.12	1411056439	1915	3239677604	1691737.65	1908	7
GCA_048593225.1	mSarHar1	Sarcophilus harrisii	7	3244907618	463558231.14	645083750	573581989.08	3	746173912	99543713	1521	3228493122	2122612.18	4514036	5951426.77	204	26331191	1	1514	16414496	10841.81	60535	58445.41	106	99990	82	1027962971:584862170:582987799:1032680182	36.17	1344951940	1521	3228493122	2122612.18	1514	7
GCA_048593285.1	mDasMac1	Dasyurus maculatus	6	3043210118	507201686.33	622380813	571347349.21	3	724078969	255383608	157	3042293817	19377667.62	93424779	141954804.04	8	323117170	13866	151	916301	6068.22	55779	52262.44	6	90455	100	971970201:548899361:548553215:972871040	36.07	1253492908	157	3042293817	19377667.62	151	6
GCA_048126345.1	mNotTyp1	Notoryctes typhlops	693	3845140558	5548543.37	356873583	470783177.55	4	761411215	3000	889	3844731014	4324781.79	88902510	102283970.97	13	247048763	570	196	409544	2089.51	25927	25744.39	6	41201	20	1195689989:726727007:726583173:1195730845	37.80	1791140733	889	3844731014	4324781.79	196	693
GCA_019393635.1	mDroGli1	Dromiciops gliroides	18	3303217110	183512061.67	670775900	590598967.27	3	764011478	6360	278	3300287221	11871536.77	38230856	45537882.14	27	112829539	162	260	2929889	11268.80	405104	339816.53	3	592959	12	1004595986:645325927:645464897:1004900411	39.11	1394484762	278	3300287221	11871536.77	260	18
GCA_027887165.1	mMonDom1	Monodelphis domestica	14	3586183679	256155977.07	538302405	484874280.93	3	760810273	17106	2269	3554276362	1566450.58	3910714	5416071.68	244	23709148	118	2255	31907317	14149.59	67741	184097.39	110	1593800	13	1102455547:673807590:673994292:1104018933	37.92	1531897160	2269	3554276362	1566450.58	2255	14
GCA_004115215.4	mOrnAna1	Ornithorhynchus anatinus	322	1859281749	5774166.92	83338043	97782050.93	7	186506016	11224	837	1844123631	2203254.04	15146802	18596688.19	36	68365665	1	515	15158118	29433.24	580424	680892.40	8	1622067	1	496779009:425428469:425358566:496557587	46.14	896301225	837	1844123631	2203254.04	515	322
GCA_015852505.1	mTacAcu1	Tachyglossus aculeatus	311	2213020595	7115821.85	63379719	83494539.82	10	176423766	1121	835	2182203212	2613417.02	19859057	21551889.69	36	62484488	23	524	30817383	58811.80	457174	626957.23	20	1644374	3	596851234:494184587:494413610:596753781	45.30	1217436987	835	2182203212	2613417.02	524	311
GCA_048771995.1	bTaeGut1	Taeniopygia guttata	42	1141165377	27170604.21	72089520	71340967.44	6	152518735	16855	51	1140849811	22369604.14	65033001	67243339.69	6	152518735	1	9	315566	35062.89	100080	95580.21	2	100085	25	326897380:243405061:243494325:327053045	42.68	255810588	51	1140849811	22369604.14	9	42
GCA_046129695.1	bLonStr1	Lonchura striata domestica	161	1207550942	7500316.41	73424396	70680590.77	6	157315129	29343	337	1207519742	3583144.64	29140630	39053508.84	11	112323262	15116	176	31200	177.27	200	187.18	78	200	100	342374227:261345501:261083641:342716373	43.26	270467331	337	1207519742	3583144.64	176	161
GCA_026979565.1	bVidCha1	Vidua chalybeata	178	1080457469	6069985.78	72553174	72893197.86	6	153566144	1354	636	1080291938	1698572.23	15819291	21529198.40	21	95478434	1354	458	165531	361.42	500	423.01	166	500	200	312078901:227991961:228167960:312053116	42.23	215421388	636	1080291938	1698572.23	458	178
GCA_027477595.1	bHaeMex1	Haemorhous mexicanus	183	1148216196	6274405.44	77212160	76680938.88	6	159305015	15589	478	1137009051	2378680.02	16787335	19595837.80	22	51821050	13869	295	11207145	37990.32	2958724	3441886.67	2	5348635	13	324270211:243888040:243981526:324869274	42.91	257781337	478	1137009051	2378680.02	295	183
GCA_963513975.1	bFriCoe1	Fringilla coelebs	460	1209243761	2628790.78	73246393	67255234.74	6	153465205	1000	1033	1209129161	1170502.58	3733973	4637349.29	94	17176682	1000	573	114600	200.00	200	200.00	287	200	200	338460822:266528223:266234420:337905696	44.06	330854683	1033	1209129161	1170502.58	573	460
GCA_028018845.1	bMelGeo1	Melospiza georgiana	40	1162015399	29050384.98	74254230	73057434.15	6	155044423	1086347	276	1160782308	4205733.00	10446106	11153873.65	36	29976604	51213	236	1233091	5224.96	48716	57504.03	7	135291	13	330557900:250269928:249768120:330186360	43.08	272551342	276	1160782308	4205733.00	236	40
GCA_035770615.1	bMelMel2	Melospiza melodia	354	1541261971	4353847.38	77460261	77453454.50	7	174870981	16779	653	1540182873	2358626.15	19453098	23404144.36	23	76059538	16779	299	1079098	3609.02	582952	338645.63	1	582952	13	424501972:346711440:345806608:423162853	44.96	588155241	653	1540182873	2358626.15	299	354
GCA_027887145.1	bAmmCau1	Ammodramus caudacutus	282	1241209685	4401452.78	78443464	72425308.06	6	157152855	14639	645	1238290578	1919830.35	8252193	11712607.86	39	43812934	14639	363	2919107	8041.62	201234	200148.50	5	391762	13	350210613:269308384:269325049:349446532	43.50	346451704	645	1238290578	1919830.35	363	282
GCA_027579445.1	bAmmNel1	Ammospiza nelsoni	77	1185463352	15395627.95	74723840	72424714.23	6	155447619	28662	292	1180370373	4042364.29	12036358	15945081.30	27	50792433	28662	215	5092979	23688.27	1448458	980008.07	2	1645319	13	336571929:253616266:254098791:336083387	43.01	294605587	292	1180370373	4042364.29	215	77
GCA_036010785.1	bAmmMai1	Ammospiza maritima	501	1397856043	2790131.82	67791739	66271045.46	7	160940846	12483	866	1395800460	1611778.82	8735889	11083285.73	43	34862124	12483	365	2055583	5631.73	142612	284909.01	3	514615	13	390840928:307634136:307059452:390265944	44.04	467577851	866	1395800460	1611778.82	365	501
GCA_031885435.1	bPasSan2	Passerculus sandwichensis	110	1270940266	11554002.42	64395891	67698835.53	7	157118810	16778	359	1268127531	3532388.67	19816254	22082982.52	21	58262181	16778	249	2812735	11296.12	910184	930051.87	2	1324262	13	357342817:276982893:276622152:357179669	43.66	326769926	359	1268127531	3532388.67	249	110
GCA_047830755.1	bZonAlb1	Zonotrichia albicollis	180	1278938765	7105215.36	64429512	70449276.88	7	156573735	12643	409	1278894965	3126882.56	17147933	25035767.96	20	78389413	11300	229	43800	191.27	200	195.43	110	200	100	359226526:280128202:279749261:359790976	43.78	273965372	409	1278894965	3126882.56	229	180
GCA_036417665.1	bPasDom1	Passer domesticus	334	1310114252	3922497.76	83066519	78072231.98	6	161085800	2000	536	1310073852	2444167.63	20590000	27676114.39	17	85645488	2000	202	40400	200.00	200	200.00	101	200	200	367190987:288210356:288124989:366547520	43.99	384328957	536	1310073852	2444167.63	202	334
GCA_014839755.1	bSylBor1	Sylvia borin	176	1045652180	5941205.57	72750092	75868691.86	5	153146699	1265	310	1043816732	3367150.75	31914676	37846052.39	10	93783096	38	134	1835448	13697.37	334230	426343.46	2	728501	13	302126732:219605261:219651965:302432774	42.08	201768653	310	1043816732	3367150.75	134	176
GCA_009819655.1	bSylAtr1	Sylvia atricapilla	189	1066786587	5644373.48	72978054	75285538.65	5	153194430	628	602	1054861233	1752261.18	7345957	9024224.97	40	25161687	375	413	11925354	28874.95	232611	285512.43	15	752739	13	306041415:221597546:221434746:305787526	42.00	201730849	602	1054861233	1752261.18	413	189
GCA_015227805.3	bHirRus1	Hirundo rustica	617	1105955550	1792472.53	76187387	75993000.51	5	156035725	668	1719	1080421139	628517.24	2794774	4137552.64	100	18822688	324	1102	25534411	23170.97	67235	160105.46	81	859144	10	310319014:229795621:229863750:310442754	42.54	223105571	1719	1080421139	628517.24	1102	617
GCA_965231275.1	bZosLat1	Zosterops lateralis	427	1143512649	2678015.57	73228557	71286319.69	6	153749042	1000	1130	1143372049	1011833.67	3151134	4182045.18	101	13824676	1000	703	140600	200.00	200	200.00	352	200	200	330094150:241841369:241739006:329697524	42.29	241432040	1130	1143372049	1011833.67	703	427
GCA_009764595.1	bGeoTri1	Geothlypis trichas	278	1078128490	3878160.04	72541719	73707002.65	6	153087655	1633	1757	1064430700	605822.82	3247339	4580272.32	82	19001305	3	1479	13697790	9261.52	69602	131806.76	45	573828	13	308956879:223808532:223308181:308357108	42.01	210774257	1757	1064430700	605822.82	1479	278
GCA_903797595.2	bEriRub2	Erithacus rubecula	1119	1086738418	971169.27	60684490	62742052.30	6	148236322	9771	2109	1086450774	515149.73	5585877	7321859.19	52	30484272	1640	990	287644	290.55	500	427.71	288	500	12	314749973:228906578:228540881:314253342	42.10	221323005	2109	1086450774	515149.73	990	1119
GCA_009819885.2	bCatUst1	Catharus ustulatus	161	1131635256	7028790.41	68462074	76842924.91	6	165774257	848	590	1118731561	1896155.19	4908935	5921096.54	70	22235935	248	429	12903695	30078.54	930933	1123456.48	5	2188653	13	321638235:237646121:237612563:321834642	42.48	242713263	590	1118731561	1896155.19	429	161
GCA_030490865.1	bPoeAtr1	Poecile atricapillus	306	1251116877	4088617.25	107919339	95368104.56	5	181565373	1000	708	1250157952	1765759.82	8462732	10386196.63	44	34538472	1000	402	958925	2385.39	12147	19059.55	18	71075	13	359894274:265137377:265030069:360096232	42.41	291548759	708	1250157952	1765759.82	402	306
GCA_029582105.1	bOenMel1	Oenanthe melanoleuca	588	1036273591	1762370.05	69618406	70727388.88	6	148394521	989	1170	1036215391	885654.18	7795761	9901860.64	39	34847410	69	582	58200	100.00	100	100.00	291	100	100	300281213:217616610:217706886:300610682	42.01	203743966	1170	1036215391	885654.18	582	588
GCA_963662255.1	bCinCin1	Cinclus cinclus	278	1170855695	4211711.13	74357285	69964066.98	6	152364536	1000	936	1170724095	1250773.61	3563180	4044994.22	103	10379991	1000	658	131600	200.00	200	200.00	329	200	200	335268242:251171033:250183352:334101468	42.82	301339039	936	1170724095	1250773.61	658	278
GCA_020745825.3	bAgePho2	Agelaius phoeniceus	409	1188530404	2905942.31	71525342	67465324.35	6	155177309	21217	515	1188478804	2307725.83	22833505	33268775.38	13	98104917	1410	106	51600	486.79	500	689.15	30	1000	100	337640435:255958563:256868365:338011441	43.15	289407101	515	1188478804	2307725.83	106	409
GCA_027559615.1	bArcTri1	Acridotheres tristis	455	1193419045	2622899.00	75254055	71975411.73	6	156254668	18654	890	1190996522	1338198.34	7308823	9387824.14	44	32755575	17121	435	2422523	5569.02	145187	229343.95	4	587868	13	343643410:251470932:252611528:343270652	42.32	257521613	890	1190996522	1338198.34	435	455
GCA_014706295.1	bLycPyr6	Lycocorax pyrrhopterus	1695	1107771238	653552.35	74168823	71589978.90	6	152208986	210	3297	1102011750	334246.82	7380351	8410721.88	44	25411417	1	1602	5759488	3595.19	5000	4856.09	575	10000	1	314686265:236837621:236370795:314117069	42.94	214720681	3297	1102011750	334246.82	1602	1695
GCA_020740725.1	bCorHaw1	Corvus hawaiiensis	187	1151594481	6158259.26	76278832	65174594.99	6	123451405	2297	481	1149781254	2390397.62	23064755	27946083.06	15	80326523	2297	294	1813227	6167.44	1373673	1052157.98	1	1373673	13	326129250:249388464:248468219:325795321	43.30	262096878	481	1149781254	2390397.62	294	187
GCA_009650955.1	bCorMon1	Corvus moneduloides	106	1112750989	10497650.84	74699841	78951721.96	5	165740467	2217	395	1083880794	2744002.01	11524098	13572630.51	30	46782926	2217	289	28870195	99896.87	891790	1044904.04	10	2429583	98	311406456:230838143:230584028:311052167	42.57	208272855	395	1083880794	2744002.01	289	106
GCA_046129655.1	bCyaCrs1	Cyanocitta cristata	316	1227176437	3883469.74	76484566	71855304.56	6	158851056	16898	709	1227102137	1730750.55	6932545	11041000.38	40	34546023	7818	393	74300	189.06	200	194.21	186	200	100	345789602:267686840:267939674:345686021	43.65	297386266	709	1227102137	1730750.55	393	316
GCA_965178545.1	bColMon1	Coloeus monedula	729	1263996688	1733877.49	75391489	69504312.96	6	161071558	1000	1377	1263867088	917841.02	3289653	4064705.66	113	18772288	1000	648	129600	200.00	200	200.00	324	200	200	352831744:278548327:279576333:352910684	44.16	263966701	1377	1263867088	917841.02	648	729
GCA_009829145.1	bChiLan1	Chiroxiphia lanceolata	93	1089631598	11716468.80	75608808	76059298.62	5	156344557	202	299	1086328087	3633204.30	18496167	26246949.68	17	92219963	202	206	3303511	16036.46	2016302	1265138.50	1	2016302	13	315110526:227885247:228011684:315320630	41.97	209303788	299	1086328087	3633204.30	206	93
GCA_036250125.1	bDixPip1	Dixiphia pipra	697	1165219370	1671763.80	75011098	74502042.33	6	156033950	1000	1020	1165154770	1142308.60	10447158	13211213.83	32	39854227	1000	323	64600	200.00	200	200.00	162	200	200	333662414:248072607:248985776:334433973	42.66	244722177	1020	1165154770	1142308.60	323	697
GCA_045364795.1	bWilVid1	Willisornis vidua	1510	1233406177	816825.28	68492996	65021076.69	7	125632909	1000	2283	1233251577	540189.04	4357226	6681466.80	70	27082362	1000	773	154600	200.00	200	200.00	387	200	200	346715433:269763692:270087464:346684988	43.77	316711956	2283	1233251577	540189.04	773	1510
GCA_016904835.1	bAcaChl1	Acanthisitta chloris	206	1077387582	5230036.81	40827287	53684441.59	8	136573486	7106	401	1073171703	2676238.66	16681756	23963840.47	17	72995027	3373	195	4215879	21619.89	73894	145081.38	14	467950	13	308841864:227396457:227698991:309234391	42.41	196869961	401	1073171703	2676238.66	195	206
GCA_004027225.2	bStrHab1	Strigops habroptilus	90	1148615375	12762393.06	83240647	83118689.39	6	155644563	17830	463	1138071294	2458037.35	9454087	10423368.53	40	27948959	1	373	10544081	28268.31	123971	250555.24	20	885493	1	330099708:238743396:238851933:330376257	41.97	227714872	463	1138071294	2458037.35	373	90
GCA_012275295.1	bMelUnd1	Melopsittacus undulatus	865	1171635651	1354492.08	104092594	89436656.04	5	155071706	1271	1149	1168399522	1016883.83	16636420	21565593.21	19	55942023	1271	284	3236129	11394.82	139565	375122.85	5	984116	13	339523788:244018111:244344529:340513094	41.80	250762409	1149	1168399522	1016883.83	284	865
GCA_028858755.1	bAraAra1	Ara ararauna	246	1224360198	4977073.98	110438430	105179439.71	5	169343748	10552	353	1223372069	3465643.25	38811057	43728431.51	10	107111114	10552	107	988129	9234.85	191219	212580.63	2	358753	13	349921095:260804721:261427317:351218936	42.69	296208800	353	1223372069	3465643.25	107	246
GCA_039720435.1	bAmaOch1	Amazona ochrocephala 	1679	1361915838	811147.01	92674118	78777770.83	6	138638134	11173	1877	1361880138	725562.14	14879228	18831306.06	26	66277070	11173	198	35700	180.30	200	189.08	90	200	100	385453496:295213409:296162188:385051045	43.42	405282539	1877	1361880138	725562.14	198	1679
GCA_037157495.1	bLatDis1	Lathamus discolor	368	1241022905	3372344.85	126105786	109157038.86	5	166042398	18672	554	1238813158	2236124.83	19972387	25185553.19	18	83049759	4407	186	2209747	11880.36	216787	287981.58	3	600373	13	355010700:264523927:264037547:355240984	42.67	315846568	554	1238813158	2236124.83	186	368
GCA_045345405.1	bGuaGua1	Guaruba guaruba	216	1366127126	6324662.62	109727540	95729495.92	5	168782984	14000	389	1366092526	3511805.98	33341676	44270753.51	12	119566610	14000	173	34600	200.00	200	200.00	87	200	200	388077340:295132782:296951621:385930783	43.34	413071562	389	1366092526	3511805.98	173	216
GCA_963264785.1	bPsiEch3	Psittacula echo	172	1203831919	6999022.78	106987384	99878734.45	5	168074981	1000	530	1203760487	2271246.20	5922112	6949613.67	65	24110086	1000	358	71432	199.53	200	199.92	179	200	32	345643295:257000676:256556785:344559731	42.66	295503087	530	1203760487	2271246.20	358	172
GCA_023634155.1	bFalPer1	Falco peregrinus	124	1311580791	10577264.44	93682670	86409728.31	6	130779382	1890	356	1307566406	3672939.34	15744644	19314343.22	24	46898215	1890	232	4014385	17303.38	278995	370761.32	5	913007	13	375276910:279518958:278128660:374641878	42.65	315169041	356	1307566406	3672939.34	232	124
GCA_015220075.1	bFalRus1	Falco rusticolus	133	1195847766	8991336.59	91094845	85113803.78	6	126922963	4121	768	1190501952	1550132.75	15323486	18425620.95	24	60549391	779	635	5345814	8418.60	134993	159078.39	13	468361	10	344323252:251396864:251016690:343765146	42.20	217019846	768	1190501952	1550132.75	635	133
GCA_023638135.1	bFalBia1	Falco biarmicus	397	1285492283	3238015.83	91472507	80068584.48	6	127364718	3434	555	1283339475	2312323.38	24892811	33653372.77	13	89694807	3434	158	2152808	13625.37	279223	257057.22	3	454465	13	365244719:275655218:276502024:365937514	43.03	294857223	555	1283339475	2312323.38	158	397
GCA_023634085.1	bFalChe1	Falco cherrug	282	1309366964	4643145.26	92426045	80233089.19	6	127826306	18187	540	1305405309	2417417.24	21245687	22227066.90	20	56117991	716	258	3961655	15355.25	323748	442303.34	4	938666	13	371186312:282427726:280896958:370894313	43.15	318338966	540	1305405309	2417417.24	258	282
GCA_017639655.1	bFalNau1	Falco naumanni	291	1215719661	4177730.79	91761059	84762407.27	6	127440759	1025	589	1211642374	2057117.78	13754753	19290570.76	25	56489468	614	298	4077287	13682.17	162567	364675.03	6	1032674	13	350065203:256591208:255940131:349045832	42.30	224937244	589	1211642374	2057117.78	298	291
GCA_963210335.1	bFalPun1	Falco punctatus	316	1279277844	4048347.61	92385878	81230819.48	6	127704412	1000	723	1279196244	1769289.41	4755657	5457405.28	87	19733697	1000	407	81600	200.49	200	200.98	203	400	200	365542117:271266704:274511299:367876124	42.67	283481780	723	1279196244	1769289.41	407	316
GCA_009819825.1	bCarCri1	Cariama cristata	110	1215245693	11047688.12	30176635	33427248.73	14	88027262	2034	304	1210312355	3981290.64	13514148	16025116.16	28	41774615	11	194	4933338	25429.58	223538	217334.10	8	534729	13	349637340:255223843:255487152:349964020	42.20	226581211	304	1210312355	3981290.64	194	110
GCA_014839835.1	bDryPub1	Dryobates pubescens	181	1187956536	6563295.78	38715865	47582049.47	11	140157326	379	368	1183953406	3217264.69	19150283	20918166.69	20	53794067	379	187	4003130	21407.11	368022	434786.77	4	800785	13	323862691:268316353:268190101:323584261	45.31	371059018	368	1183953406	3217264.69	187	181
GCA_015220805.1	bPogPus1	Pogoniulus pusillus	253	1272358903	5029086.57	33994490	39840995.62	13	117909544	5358	560	1266346146	2261332.40	16792259	18226827.13	25	47589575	1797	307	6012757	19585.53	173817	290301.43	9	824725	13	342013845:290824047:291203073:342305181	45.96	446331334	560	1266346146	2261332.40	307	253
GCA_009819595.1	bMerNub1	Merops nubicus	109	1149356202	10544552.31	49132790	51290188.02	9	81488222	6502	378	1143301140	3024606.19	12372304	15429846.00	26	41280599	1536	269	6055062	22509.52	131327	1169270.64	4	2610509	13	326362803:245038072:245194651:326705614	42.88	224935606	378	1143301140	3024606.19	269	109
GCA_009769605.1	bBucAby1	Bucorvus abyssinicus	112	1132597561	10112478.22	40274051	50408305.23	9	136452362	2790	316	1124523019	3558617.15	12039478	14119369.54	29	38151749	802	204	8074542	39581.09	187541	435625.75	10	1528092	13	318493317:243097054:243791425:319141223	43.30	210708068	316	1124523019	3558617.15	204	112
GCA_020746105.1	bTroSur1	Trogon surrucura	182	1165749515	6405217.12	82617956	93688524.00	5	222214447	1349	435	1155478760	2656273.01	16237294	18147070.16	23	44073144	726	253	10270755	40595.87	241935	347944.43	12	1121181	13	330745128:247517451:247051513:330164668	42.80	255034707	435	1155478760	2656273.01	253	182
GCA_034619465.1	bLepDis1	Leptosomus discolor	278	1332047658	4791538.34	82124922	86467017.17	6	219330182	11844	549	1331993458	2426217.59	8826436	11548236.30	43	42063349	11844	271	54200	200.00	200	200.00	136	200	200	374931977:290875094:291012529:375173858	43.69	278053853	549	1331993458	2426217.59	271	278
GCA_028858725.2	bColStr4	Colius striatus	190	1212464869	6381394.05	89023854	85298926.76	5	206588619	12990	348	1206617144	3467290.64	21931325	31017857.09	16	111994057	12990	158	5847725	37010.92	1918310	1414548.98	2	1995978	13	348175433:255156658:255086214:348198839	42.29	275390146	348	1206617144	3467290.64	158	190
GCA_031877795.1	bStrAlu1	Strix aluco	203	1414802443	6969470.16	89389700	83124306.04	6	173077747	19298	484	1410489790	2914235.10	11872084	15418624.65	33	44761009	3101	281	4312653	15347.52	250699	1096788.08	2	2116532	13	403197545:301692549:300644263:404955433	42.70	377068277	484	1410489790	2914235.10	281	203
GCA_965140245.1	bAthNoc1	Athene noctua	717	1355875761	1891040.11	86326089	103307227.71	5	265814424	1000	1289	1355761361	1051793.14	4050372	4901980.32	101	21476446	1000	572	114400	200.00	200	200.00	286	200	200	383179275:295062996:293927975:383591115	43.44	331206583	1289	1355761361	1051793.14	572	717
GCA_900496995.4	bAquChr1	Aquila chrysaetos	145	1233723095	8508435.14	46934974	53690184.09	9	88216475	1203	373	1228521835	3293624.22	21924221	24674981.20	19	76091984	252	228	5201260	22812.54	181657	281623.87	7	680545	12	355057645:258779140:259160900:355524150	42.16	239380846	373	1228521835	3293624.22	228	145
GCA_947461875.1	bHalAlb1	Haliaeetus albicilla	188	1320298205	7022862.79	44398590	46840544.75	12	85729264	1000	612	1320213405	2157211.45	4576000	5706164.92	85	18990351	1000	424	84800	200.00	200	200.00	212	200	200	375079233:284389982:285262109:375482081	43.15	303477942	612	1320213405	2157211.45	424	188
GCA_026419915.1	bHarHar1	Harpia harpyja	322	1351447071	4197040.59	58111031	64204508.02	8	117051599	1578	664	1348795677	2031318.79	16799191	19766241.78	26	66700503	643	342	2651394	7752.61	144201	224406.32	5	484506	13	382689753:292775839:292503134:380826951	43.39	327081242	664	1348795677	2031318.79	342	322
GCA_045345515.1	bMorGui1	Morphnus guianensis	544	1576624229	2898206.30	61450600	58342440.71	10	102737265	15115	708	1576591429	2226824.05	26372894	28282591.27	21	79808863	15115	164	32800	200.00	200	200.00	82	200	200	437249200:350325569:348050225:440966435	44.30	520864741	708	1576591429	2226824.05	164	544
GCA_929443795.1	bAccGen1	Astur gentilis	455	1398027955	3072588.91	35025567	36614331.99	15	89764762	1000	638	1397991355	2191209.02	17712854	17962654.25	27	45294000	1000	183	36600	200.00	200	200.00	92	200	200	392724541:305687654:306358821:393220339	43.78	373314682	638	1397991355	2191209.02	183	455
GCA_028022735.1	bGypBar2	Gypaetus barbatus	232	1365299843	5884913.12	52189775	57345077.56	10	91544569	19635	491	1363299411	2776577.21	18064636	20522066.67	24	57496451	19635	259	2000432	7723.68	119145	403809.82	3	853331	13	384718854:297398917:295664643:385516997	43.50	354088597	491	1363299411	2776577.21	259	232
GCA_964188355.1	bButBut1	Buteo buteo	544	1303700921	2396509.05	46961128	49064212.06	10	89587085	7705	1015	1303606721	1284341.60	4249591	5550016.44	88	23540479	7705	471	94200	200.00	200	200.00	236	200	200	370348875:281191117:281523778:370542951	43.17	303742414	1015	1303606721	1284341.60	471	544
GCA_037962945.1	bSarPap1	Sarcoramphus papa	124	1543950730	12451215.56	96420541	104591281.83	5	234816392	11892	278	1543919930	5553668.81	40899883	67104733.55	10	233235662	11892	154	30800	200.00	200	200.00	77	200	200	430495590:338488401:342671912:432264027	44.12	493069138	278	1543919930	5553668.81	154	124
GCA_030463565.1	bPelCri1	Pelecanus crispus	311	1314587946	4226970.89	86807213	108535961.91	5	227928177	16542	701	1314509946	1875192.50	9666746	13399739.97	36	48701803	16542	390	78000	200.00	200	200.00	195	200	200	371582694:285067692:285506498:372353062	43.41	273594281	701	1314509946	1875192.50	390	311
GCA_020745775.1	bTheCae1	Theristicus caerulescens	88	1203372763	13674690.49	101368359	98394521.65	5	168284945	4648	192	1201104556	6255752.90	37098842	43794009.16	10	106660216	3157	104	2268207	21809.68	170428	247367.41	4	547300	13	346022154:254427626:254513960:346140816	42.37	233550658	192	1201104556	6255752.90	104	88
GCA_965183815.1	bPlaLeu2	Platalea leucorodia	669	1345843103	2011723.62	94714899	91795300.84	6	169228035	1000	1372	1345702503	980832.73	3299000	3992288.54	121	12216800	1000	703	140600	200.00	200	200.00	352	200	200	379018552:292842832:294156218:379684901	43.62	303420242	1372	1345702503	980832.73	703	669
GCA_949628215.1	bGulAri2.1	Gulosus aristotelis	353	1279134750	3623611.19	78889319	100185481.67	5	219240020	1000	575	1279090533	2224505.27	11420000	13710862.25	34	42241340	1000	222	44217	199.18	200	199.93	111	200	17	363984965:275405768:275842990:363856810	43.10	283419557	575	1279090533	2224505.27	222	353
GCA_963921805.1	bPhaCar2	Phalacrocorax carbo	351	1283643005	3657102.58	84621172	99707883.42	5	218912229	1000	844	1283544405	1520787.21	4631399	5646725.15	84	17734608	1000	493	98600	200.00	200	200.00	247	200	200	362662387:278643931:279286912:362951175	43.47	281468095	844	1283544405	1520787.21	493	351
GCA_031468815.1	bMorBas2	Morus bassanus	421	1294804326	3075544.72	85624757	78433099.22	6	170178824	9928	669	1294754726	1935358.33	10178591	11944731.03	40	42930975	9928	248	49600	200.00	200	200.00	124	200	200	372925400:275348358:274091962:372389006	42.44	262677709	669	1294754726	1935358.33	248	421
GCA_017639555.1	bCicMag1	Ciconia maguari	153	1239437416	8100898.14	85554746	105772397.23	5	220367150	1208	385	1217227625	3161630.19	23757428	23890974.55	18	64002882	486	232	22209791	95731.86	794119	1162588.96	7	2810253	13	352379054:256396222:256311130:352141219	42.12	234593208	385	1217227625	3161630.19	232	153
GCA_964195595.2	bCalBor7	Calonectris borealis	355	1366205003	3848464.80	86023716	94444779.12	5	221108703	1000	880	1366099988	1552386.35	4142416	4923479.57	99	15265181	1000	525	105015	200.03	200	200.03	263	215	200	386588088:295865757:295539371:388106772	43.29	329530681	880	1366099988	1552386.35	525	355
GCA_027474245.1	bSphHub1	Spheniscus humboldti	136	1358357718	9987924.40	89079306	109364788.34	5	231542106	17816	389	1357302657	3489209.92	13936613	17012300.55	30	57147220	17816	253	1055061	4170.20	49720	186984.76	3	427566	13	380817605:298786146:297168766:380530140	43.91	341805253	389	1357302657	3489209.92	253	136
GCA_030936135.1	bGavSte3	Gavia stellata	1186	1321287916	1114070.76	50637386	60950168.78	8	133328454	17343	1435	1321238116	920723.43	13765203	15548254.43	31	62764780	17343	249	49800	200.00	200	200.00	125	200	200	375192340:284471423:285088094:376486259	43.11	303175453	1435	1321238116	920723.43	249	1186
GCA_964289735.1	bPhaAeh10	Phaethon aethereus	657	1321027743	2010696.72	85546101	98501438.08	5	224165678	1000	1926	1320773943	685760.10	2122569	2607929.18	181	10023229	1000	1269	253800	200.00	200	200.00	635	200	200	375513900:285200317:284692536:375367190	43.15	322166808	1926	1320773943	685760.10	1269	657
GCA_027574665.1	bRhyJub1	Rhynochetos jubatus	148	1331454348	8996313.16	63592491	69660929.75	7	148633065	17051	448	1330929107	2970823.90	10485863	12918078.11	36	33969142	5083	300	525241	1750.80	22199	46883.22	6	139650	13	365956956:300160172:299751773:365060206	45.07	367872267	448	1330929107	2970823.90	300	148
GCA_017639485.1	bPluApr1	Pluvialis apricaria	107	1247767512	11661378.62	87527607	105986798.95	5	222690203	3688	375	1235472775	3294594.07	15203797	21179057.87	23	79609756	495	268	12294737	45875.88	325410	477784.70	10	1320089	13	353889966:263844695:263713142:354024972	42.70	256679703	375	1235472775	3294594.07	268	107
GCA_965231255.1	bVanVan1	Vanellus vanellus	2408	1476623026	613215.54	82789932	88712329.49	6	223038323	1000	3344	1476435826	441517.89	1930563	2572920.59	211	10198671	1000	936	187200	200.00	200	200.00	468	200	200	409171307:330314633:327152815:409797071	44.53	471566293	3344	1476435826	441517.89	936	2408
GCA_008658365.1	bAlcTor1	Alca Torda	95	1178492568	12405184.93	84526827	105188600.65	4	215872496	13591	322	1174931441	3648855.41	18221265	18676501.89	23	48160765	18	227	3561127	15687.78	76607	129471.67	12	351905	10	336677758:250540549:250744010:336969124	42.67	229445144	322	1174931441	3648855.41	227	95
GCA_964106895.1	bNumArq3	Numenius arquata	1819	1348876333	741548.29	63363742	66826363.31	8	141981056	1000	2604	1348719333	517941.37	2605715	3825338.74	133	19121832	1000	785	157000	200.00	200	200.00	393	200	200	377811085:295726125:297415627:377766496	43.98	373810446	2604	1348719333	517941.37	785	1819
GCA_009819605.1	bSteHir1	Sterna hirundo	123	1229972541	9999776.76	85487239	109243231.77	5	220148669	1608	328	1219607931	3718316.86	22002498	25203837.37	18	71563357	464	205	10364610	50559.07	586445	1086169.81	4	2507864	13	347213320:262350291:262487098:347557222	43.03	250311342	328	1219607931	3718316.86	205	123
GCA_028500815.1	bRisTri1	Rissa tridactyla	716	1353621101	1890532.26	88208671	99842508.93	5	219604264	13704	999	1352834728	1354188.92	15653959	21680944.49	24	88849838	13704	283	786373	2778.70	24201	26040.18	11	55470	13	376189844:300278113:300361171:376005600	44.40	353021069	999	1352834728	1354188.92	283	716
GCA_963924245.1	bChrRid1	Chroicocephalus ridibundus	729	1417571123	1944542.01	83755488	96687068.55	6	220911672	1000	1191	1417478723	1190158.46	4003687	4902485.60	105	16364000	1000	462	92400	200.00	200	200.00	231	200	200	392641896:316656395:316411925:391768507	44.66	435347980	1191	1417478723	1190158.46	462	729
GCA_963932225.1	bLarFus1	Larus fuscus	1367	1324286540	968753.87	86500895	100361016.18	5	218474787	1000	1904	1324179125	695472.23	3570916	4629569.05	106	17225182	1000	537	107415	200.03	200	200.03	269	215	200	368359297:294293184:293672978:367853666	44.40	350789861	1904	1324179125	695472.23	537	1367
GCA_964199755.1	blarMic1	Larus michahellis	618	1405581498	2274403.72	87713602	99773605.12	5	224375286	1000	1118	1405481498	1257139.09	4216312	5197829.86	98	17663599	1000	500	100000	200.00	200	200.00	250	200	200	388684192:313577996:313864006:389355304	44.64	409435831	1118	1405481498	1257139.09	500	618
GCA_964417175.1	bLarArg3	Larus argentatus	401	1417856064	3535800.66	88668981	98968392.74	5	220808802	1000	960	1417744264	1476816.94	3525167	4920260.35	114	25645585	1000	559	111800	200.00	200	200.00	280	200	200	391965575:317795009:317367244:390616436	44.80	409265628	960	1417744264	1476816.94	559	401
GCA_011004875.1	bBalReg1	Balearica regulorum gibbericeps	105	1221051782	11629064.59	82577926	101241761.03	5	219267915	1068	249	1216255745	4884561.22	23326060	32913565.12	14	79692185	563	144	4796037	33305.81	195457	213663.11	9	402205	13	350439230:257819735:257633742:350363038	42.38	241549382	249	1216255745	4884561.22	144	105
GCA_028858705.1	bGruAme1	Grus americana	929	1257821324	1353951.91	82903739	98160559.04	5	219868338	1626	1191	1253145146	1052178.96	28324902	42453265.93	11	111907498	1626	262	4676178	17848.01	149653	229315.74	8	543171	8	357103802:270693737:269014573:356333034	43.07	270201976	1191	1253145146	1052178.96	262	929
GCA_964106855.1	bGruGru1	Grus grus	754	1352282554	1793478.19	83713171	94995268.10	5	224747368	1000	1347	1352163954	1003833.67	3365458	4133859.33	116	12994772	1000	593	118600	200.00	200	200.00	297	200	200	377911039:300992300:297216713:376043902	44.24	354040152	1347	1352163954	1003833.67	593	754
GCA_020800305.1	bPorHoc1	Porphyrio hochstetteri	174	1270294353	7300542.26	71566193	97523491.27	5	224114340	3912	501	1264978104	2524906.40	13461271	14298185.28	31	42507593	1467	327	5316249	16257.64	355237	478592.45	5	1200522	13	356145761:276874760:276442171:355515412	43.74	320589007	501	1264978104	2524906.40	327	174
GCA_964237585.1	bGalChl1	Gallinula chloropus	818	1282411533	1567740.26	90336355	94025002.23	5	215888759	1000	1421	1282290933	902386.30	3673000	4535252.64	104	17049112	1000	603	120600	200.00	200	200.00	302	200	200	354501952:286358823:286855996:354574162	44.70	320069551	1421	1282290933	902386.30	603	818
GCA_030867145.1	bOpiHoa1	Opisthocomus hoazin	415	1482459898	3572192.53	80946297	75065538.77	7	157519659	14498	683	1482406298	2170433.82	14274197	19039304.59	30	84052069	14498	268	53600	200.00	200	200.00	134	200	200	403208716:337107887:338252255:403837440	45.56	359350482	683	1482406298	2170433.82	268	415
GCA_003957555.2	bCalAnn1	Calypte anna	160	1059706240	6623164.00	74081004	88530465.04	4	197551010	4777	589	1043609452	1771832.69	14522327	17728472.66	21	48747865	5	429	16096788	37521.65	234592	260440.59	24	664828	1	305583664:216610020:216429140:304986628	41.49	213567080	589	1043609452	1771832.69	429	160
GCA_023637945.2	bPhaSup1	Phaethornis superciliosus	65	1020009783	15692458.20	72671965	90006273.20	4	196608326	6938	205	1016199569	4957071.07	35194150	48404027.94	8	123323939	587	140	3810214	27215.81	396544	388815.11	4	609119	13	299858788:208345734:208326839:299668208	41.00	197758163	205	1016199569	4957071.07	140	65
GCA_036169615.1	bHelExo1	Heliangelus exortis	131	1049650714	8012600.87	73898144	89226556.11	4	198225612	14374	568	1049565314	1847826.26	8413062	10552004.60	36	31562205	8593	437	85400	195.42	200	197.66	214	200	100	306184910:218598316:218374585:306407503	41.63	214239128	568	1049565314	1847826.26	437	131
GCA_020740795.1	bApuApu2	Apus apus	109	1100361224	10095057.10	115508478	102046908.94	4	206448969	5569	365	1098613695	3009900.53	25561769	29951370.41	13	64717578	24	256	1747529	6826.29	95619	108106.83	6	198632	11	318946524:230556132:230351841:318759198	41.95	225574036	365	1098613695	3009900.53	256	109
GCA_020745705.1	bHemCom1	Hemiprocne comata	146	1164813063	7978171.66	91346199	102790259.63	4	218408531	420	364	1154638596	3172084.05	20531774	23188864.14	18	52779268	420	218	10174467	46671.87	238550	457164.80	10	1346558	13	334270302:243108463:243182067:334077764	42.12	242694179	364	1154638596	3172084.05	218	146
GCA_907165065.1	bCapEur3	Caprimulgus europaeus	121	1177791212	9733811.67	82614289	70088358.14	6	126318510	10341	274	1177765377	4298413.78	30622946	40435767.39	11	100763099	3179	153	25835	168.86	200	248.69	43	500	35	342098549:247080293:246819795:341766740	41.94	252643583	274	1177765377	4298413.78	153	121
GCA_039906565.1	bAegAlb1	Aegotheles albertisi	592	1167497019	1972123.34	46898397	53958616.88	8	109817262	3436	1031	1167409219	1132307.68	9620782	9566864.86	41	21716903	3436	439	87800	200.00	200	200.00	220	200	200	335413423:248088307:248257072:335650417	42.52	245127213	1031	1167409219	1132307.68	439	592
GCA_028020825.1	bPodStr1	Podargus strigoides	1038	1271141449	1224606.41	58393285	69197747.02	7	177501524	17139	1241	1268974171	1022541.64	11637970	19334359.02	27	79645112	17139	203	2167278	10676.25	494826	439338.24	2	785652	13	367234195:268300813:269091537:364347626	42.35	343336634	1241	1268974171	1022541.64	203	1038
GCA_013368605.1	bNycGra1	Nyctibius grandis	191	1256414880	6578088.38	92359233	78361773.73	6	133763977	2716	434	1250275747	2880819.69	23231768	37917722.21	13	94894540	1050	243	6139133	25263.92	283846	379727.09	6	847631	13	357856690:266363254:267119855:358935948	42.67	292301483	434	1250275747	2880819.69	243	191
GCA_036417535.1	bChlMac1	Chlamydotis macqueenii	329	1273933319	3872137.75	84623986	96590416.81	5	215693158	16918	429	1273913319	2969494.92	25335467	45572198.56	10	122418308	16918	100	20000	200.00	200	200.00	50	200	200	360616825:274528231:276435756:362332507	43.25	277991385	429	1273913319	2969494.92	100	329
GCA_009769465.1	bTauEry1	Tauraco erythrolophus	140	1252271553	8944796.81	85562082	74165388.09	6	136888462	3169	484	1225870858	2532791.03	11927027	16754559.60	29	78144336	911	344	26400695	76746.21	279559	392503.31	24	1126833	13	351894112:261142885:261087312:351746549	42.60	263056250	484	1225870858	2532791.03	344	140
GCA_017976375.1	bCucCan1	Cuculus canorus	151	1180156273	7815604.46	78325852	95634178.15	5	209323829	587	447	1175233958	2629158.74	20797936	26549072.29	17	86316243	127	296	4922315	16629.44	271792	380610.29	6	946057	13	339840430:247875237:247790039:339728252	42.18	247611882	447	1175233958	2629158.74	296	151
GCA_009769525.1	bPteGut1	Pterocles gutturalis	89	1127422757	12667671.43	43262132	60405314.12	8	132921182	21595	331	1123119200	3393109.37	12131577	10734071.52	37	23756606	2549	242	4303557	17783.29	403473	572143.40	3	1159577	11	323600040:238185098:237991963:323342099	42.40	221028530	331	1123119200	3393109.37	242	89
GCA_901699155.2	bStrTur1	Streptopelia turtur	311	1178816852	3790407.88	81365208	103025866.47	4	222115097	5486	1251	1174936278	939197.66	3730413	4880697.49	89	18346939	222	940	3880574	4128.27	54195	64595.07	23	156350	2	341733191:245924541:245706622:341571924	41.84	240604284	1251	1174936278	939197.66	940	311
GCA_964273445.1	bStrDea1	Streptopelia decaocto	2451	1290957608	526706.49	78754139	92120924.11	5	213210830	1000	3147	1290818408	410174.26	2425281	3464115.71	137	16122701	1000	696	139200	200.00	200	200.00	348	200	200	374332034:272163764:267335551:376987059	41.80	377359720	3147	1290818408	410174.26	696	2451
GCA_963082525.1	bNesMay2	Nesoenas mayeri	143	1183271950	8274629.02	78184682	97633922.66	5	214152265	1000	652	1183170150	1814678.14	4840756	5848016.38	75	18893325	1000	509	101800	200.00	200	200.00	255	200	200	341799217:249991987:250089121:341289825	42.27	260999424	652	1183170150	1814678.14	509	143
GCA_036013445.1	bCalNic1	Caloenas nicobarica	807	1285851275	1593372.09	79699707	94658158.21	5	216431472	16521	924	1285830875	1391591.86	25101800	33378463.33	14	97706909	15010	117	20400	174.36	200	185.29	51	200	100	359562377:287976639:286012365:352279494	44.64	351280510	924	1285830875	1391591.86	117	807
GCA_036971685.2	bPatFas1	Patagioenas fasciata	441	1198742887	2718237.84	70857732	95974728.41	5	215622551	5717	505	1194122847	2364599.70	63448456	57938895.32	7	132376218	1	64	4620040	72188.13	3464210	2689386.58	1	3464210	13	337305564:260418658:260322764:336075861	43.61	319283615	505	1194122847	2364599.70	64	441
GCA_036013475.2	bColLiv1	Columba livia	870	1325583311	1523658.98	68980706	87006066.82	6	212386202	12895	1119	1325536411	1184572.31	14042120	16440336.99	28	54502558	12895	249	46900	188.35	200	193.82	118	200	100	389063789:276519494:280197704:379755424	42.00	386731470	1119	1325536411	1184572.31	249	870
GCA_009819775.1	bPhoRub2	Phoenicopterus ruber	90	1246226932	13846965.91	85472901	101979054.86	5	220917696	1822	370	1237624816	3344931.94	14700712	18707547.53	26	73216010	1822	280	8602116	30721.84	184621	349189.37	11	1146645	13	350509799:267473503:268087868:351553646	43.27	253117188	370	1237624816	3344931.94	280	90
GCA_016700215.2	bGalGal1	Gallus gallus	276	1050511239	3806200.14	90563926	94417096.23	4	196242913	1219	685	1046014928	1527029.09	17744542	22025181.83	18	61366121	1214	409	4496311	10993.43	211853	297184.96	6	734148	2	302330803:220416362:220627233:302640530	42.16	212403645	685	1046014928	1527029.09	409	276
GCA_023343835.1	bLagMut1	Lagopus muta	164	1026755127	6260701.99	71229700	83244651.91	5	194907523	2258	374	1026683190	2745142.22	17905263	20319023.51	19	46643962	171	210	71937	342.56	500	430.38	72	500	23	299963160:213075461:213671748:299972821	41.57	216333297	374	1026683190	2745142.22	210	164
GCA_951394365.1	bTetUro1.1	Tetrao urogallus	318	1013184029	3186113.30	71401156	83681863.15	5	193917226	1000	1291	1012989429	784654.86	1909808	2456956.57	152	10141983	1000	973	194600	200.00	200	200.00	487	200	200	296427623:210133294:210174561:296253951	41.49	207259759	1291	1012989429	784654.86	973	318
GCA_039878825.1	bCotChi1	Coturnix chinensis	191	966847183	5062027.14	86361526	90362958.64	4	183816686	17297	521	966783983	1855631.45	7816141	12084334.60	33	58689280	7608	330	63200	191.52	200	195.57	158	200	100	282136747:201301486:201242068:282103682	41.64	191540547	521	966783983	1855631.45	330	191
GCA_009819795.1	bAytFul2	Aythya fuligula	104	1126988109	10836424.13	85905639	96862745.03	4	207018403	2927	267	1117570712	4185658.10	17816505	22982432.40	19	75293206	329	163	9417397	57775.44	251546	277129.81	12	688423	13	326007597:232802339:232727381:326033395	41.66	244389499	267	1117570712	4185658.10	163	104
GCA_964211825.1	bAytFer1	Aythya ferina	862	1252319576	1452806.93	79844515	89108712.30	5	207520437	1000	1336	1252224776	937293.99	4150808	4758781.20	94	17540155	1000	474	94800	200.00	200	200.00	237	200	200	363083932:265324437:262928922:360887485	42.19	339285562	1336	1252224776	937293.99	474	862
GCA_965140915.1	bAytMar2	Aythya marila	1269	1224533240	964959.21	77037309	89348361.18	5	207581217	1000	1962	1224394640	624054.35	3182246	3668181.41	121	15900537	1000	693	138600	200.00	200	200.00	347	200	200	356184338:260583785:255487411:352139106	42.15	316487482	1962	1224394640	624054.35	693	1269
GCA_964035555.1	bNetRuf1	Netta rufina	141	1166978622	8276444.13	77261329	93602817.06	5	206794109	1000	855	1166835822	1364720.26	3347974	4054153.83	107	15032000	1000	714	142800	200.00	200	200.00	357	200	200	338053668:245639873:245390023:337752258	42.08	277764532	855	1166835822	1364720.26	714	141
GCA_964188345.1	bAnaPla2	Anas platyrhynchos	936	1300248985	1389154.90	69288905	86016716.73	6	207338842	1000	1507	1300134785	862730.45	3518761	4458621.88	108	17902756	1000	571	114200	200.00	200	200.00	286	200	200	372775446:279134040:278214262:370011037	42.87	358142925	1507	1300134785	862730.45	571	936
GCA_009769625.2	bCygOlo1	Cygnus olor	171	1134186636	6632670.39	81481363	97431586.51	4	209522193	711	622	1124263911	1807498.25	8308965	10073647.23	39	30497565	298	451	9922725	22001.61	49391	90602.96	49	398251	13	326653792:235753889:235524306:326331924	41.92	234081739	622	1124263911	1807498.25	451	171
GCA_963932015.1	bAnaAcu1	Anas acuta	395	1189313589	3010920.48	76435830	90306606.11	5	205008147	1000	1026	1189187708	1159052.35	3416933	4225610.27	102	15556000	1000	631	125881	199.49	200	199.95	315	219	25	341457520:252957106:253190478:341582604	42.56	299392933	1026	1189187708	1159052.35	631	395
GCA_965231335.1	bBraCan1	Branta canadensis	614	1311899232	2136643.70	78989891	88986364.97	5	213660330	1000	1145	1311793032	1145670.77	3892771	4779284.61	100	14639950	1000	531	106200	200.00	200	200.00	266	200	200	367491904:289802493:289071015:365427620	44.13	382702747	1145	1311793032	1145670.77	531	614
GCA_040182565.1	bAnsCyg1	Anser cygnoides	74	1215337776	16423483.46	81007908	95284720.32	5	212801650	89760	116	1215331076	10476992.03	39655246	78559451.32	7	212801650	1	42	6700	159.52	200	174.63	17	200	100	346274081:262125451:261300646:345630898	43.07	289593755	116	1215331076	10476992.03	42	74
GCA_964034855.1	bAnsBra1	Anser brachyrhynchus	715	1287337719	1800472.33	79251119	89945025.65	5	213089697	1000	1852	1287110319	694983.97	2049950	2699765.12	178	12412735	1000	1137	227400	200.00	200	200.00	569	200	200	362366422:280855152:281403771:362484974	43.68	370784449	1852	1287110319	694983.97	1137	715
GCA_964211835.1	bAnsAns1	Anser anser	819	1313455045	1603730.21	78965412	90208654.98	5	215877093	1000	1749	1313269045	750868.52	2674135	3208112.36	147	14486993	1000	930	186000	200.00	200	200.00	465	200	200	370804595:286311031:285350641:370802778	43.53	364552047	1749	1313269045	750868.52	930	819
GCA_964059595.1	bBucCla1	Bucephala clangula	538	1190938797	2213640.89	66356865	66434064.17	7	130642613	1000	992	1190848172	1200451.79	4272793	5064850.94	85	14664558	1000	454	90625	199.61	200	199.95	227	200	25	344543260:250242632:250748348:345313932	42.07	288601965	992	1190848172	1200451.79	454	538
GCA_963989345.1	bClaHye2	Clangula hyemalis	272	1206104048	4434206.06	78069974	91498580.18	5	207631701	1000	816	1205995423	1477935.57	3738964	4434037.20	100	13508227	1000	544	108625	199.68	200	199.96	272	200	25	348698032:255777243:254410440:347109708	42.30	306240780	816	1205995423	1477935.57	544	272
GCA_965151615.1	bCygCol1	Cygnus columbianus	603	1293538149	2145171.06	78162771	87998083.74	5	211451100	1000	1143	1293430149	1131609.93	3838603	4841181.16	97	14554797	1000	540	108000	200.00	200	200.00	270	200	200	357024225:293341658:289166665:353897601	45.04	363446979	1143	1293430149	1131609.93	540	603
GCA_036873955.1	bMerOct1	Mergus octosetaceus	569	1245791205	2189439.73	83836255	97267880.59	5	216678325	12909	896	1245734246	1390328.40	10800487	12544736.53	34	34660131	671	327	56959	174.19	200	185.60	143	200	25	358185474:264477257:263924706:359146809	42.42	346891761	896	1245734246	1390328.40	327	569
GCA_040807025.1	bStrCam1	Struthio camelus australis	263	1452035523	5521047.62	84633522	100252246.37	6	225574516	12520	379	1452012323	3831167.08	28829471	39494261.04	14	123769770	12520	116	23200	200.00	200	200.00	58	200	200	404800350:322991110:320798160:403422703	44.34	341757603	379	1452012323	3831167.08	116	263
GCA_047922985.1	bEudEle1	Eudromia elegans	397	1109691113	2795191.72	66803183	83088396.09	5	189958320	1000	696	1109647413	1594321.00	11629215	14428737.80	29	48105448	1000	299	43700	146.15	200	163.16	110	200	100	309340351:245123983:246618912:308564167	44.32	272866548	696	1109647413	1594321.00	299	397
GCA_036370855.1	bDroNov1	Dromaius novaehollandiae	272	1468722890	5399716.51	77929039	92730933.41	6	219529801	6032	401	1468697090	3662586.26	24239989	25049545.18	21	61638557	6032	129	25800	200.00	200	200.00	65	200	200	412895385:321947074:321229534:412625097	43.79	342473445	401	1468697090	3662586.26	129	272
GCA_036417845.1	bAptMan1	Apteryx mantelli	409	1504415252	3678276.90	88095958	93077541.77	6	222926480	7863	579	1504381252	2598240.50	19797665	23048737.41	24	73202259	7863	170	34000	200.00	200	200.00	85	200	200	420915821:330313352:331759048:421393031	44.01	405349341	579	1504381252	2598240.50	170	409
GCA_028389875.1	bPtePen1	Rhea pennata	179	1269000025	7089385.61	82467789	95574427.41	5	216936262	22241	307	1267548352	4128821.99	19335416	24997530.60	19	86083197	22241	128	1451673	11341.20	1186329	980381.35	1	1186329	13	365099387:269692824:268325656:364430485	42.45	279845800	307	1267548352	4128821.99	128	179
GCA_030867095.1	rAllMis1	Alligator mississippiensis	194	2346779227	12096800.14	255078640	253220346.07	4	486595084	19498	355	2330325380	6564296.85	38556409	50187616.61	18	130487753	19498	161	16453847	102197.81	768703	1203616.65	5	2756256	13	641042731:524796100:524027532:640459017	45.01	737172547	355	2330325380	6564296.85	161	194
GCA_030020295.1	rGavGan2	Gavialis gangeticus	160	2328538659	14553366.62	257319116	250550466.02	4	473287416	1000	278	2327430548	8372052.33	84235120	84404127.10	10	170598524	1000	118	1108111	9390.77	82028	142434.14	4	316809	13	638433228:525657514:525064017:638275789	45.15	700860151	278	2327430548	8372052.33	118	160
GCA_033958435.1	ASM3395843v1	Carettochelys insculpta	134	2180317067	16271022.89	130115908	166705416.68	5	383128740	15113	146	2180314667	14933662.10	126464372	151756025.31	5	383128740	15113	12	2400	200.00	200	200.00	6	200	200	593522446:496574228:496499984:593718009	45.55	731590676	146	2180314667	14933662.10	12	134
GCA_015237465.2	rCheMyd1	Chelonia mydas	92	2134358617	23199550.18	134428053	163989398.44	5	348265484	3063	390	2122398441	5442047.28	39415510	46322642.98	17	107684605	71	298	11960176	40134.82	873136	895276.10	5	1638132	13	594093851:466992810:467080695:594231085	44.01	669366587	390	2122398441	5442047.28	298	92
GCA_965140235.1	rCarCar2	Caretta caretta	36	2217236305	61589897.36	137541926	167853361.30	5	355489124	33007	97	2216652588	22852088.54	124322749	141095824.70	7	354291630	33007	61	583717	9569.13	70800	104810.46	3	199237	13	619178142:488940633:489151846:619381967	44.12	749235692	97	2216652588	22852088.54	61	36
GCA_965140285.1	rLepKem1	Lepidochelys kempii	54	2219022919	41093017.02	136730895	166091718.08	5	354026373	15871	273	2218980219	8128132.67	52784435	76490356.27	10	204525152	15871	219	42700	194.98	200	197.42	107	200	100	619388350:489971349:489923936:619696584	44.16	746293314	273	2218980219	8128132.67	219	54
GCA_965140295.1	rLepOli2	Lepidochelys olivacea	44	2206585630	50149673.41	137258246	167614530.12	5	355274122	1000	113	2206197640	19523872.92	91320439	91811558.71	9	207144602	1000	69	387990	5623.04	48716	57395.09	3	115128	13	616213173:486617814:486873811:616492842	44.13	753289069	113	2206197640	19523872.92	69	44
GCA_965152275.1	rNatDep1	Natator depressus	41	2173446978	53010901.90	134157645	163940182.34	5	349163694	16559	212	2173416477	10251964.51	77014821	80256082.43	10	197234058	16559	171	30501	178.37	200	187.87	77	200	100	606044774:480714793:480515564:606141346	44.23	702905724	212	2173416477	10251964.51	171	41
GCA_965152235.1	rEreImb1	Eretmochelys imbricata	57	2218003986	38912350.63	136542973	168625414.34	5	361961700	16779	188	2215232503	11783151.61	80323000	87635809.73	9	168211929	10909	131	2771483	21156.36	150605	192669.63	6	478691	13	619759139:487737236:487753917:619982211	44.04	722673888	188	2215232503	11783151.61	131	57
GCA_033349115.1	rMacSuw1	Macrochelys suwanniensis	199	1937254095	9734945.20	133157836	165437874.63	5	335304700	18435	560	1937181895	3459253.38	28400779	40323690.78	17	118820932	18435	361	72200	200.00	200	200.00	181	200	200	544689644:423981769:423943726:544566756	43.77	620799520	560	1937181895	3459253.38	361	199
GCA_009764565.4	rDerCor1	Dermochelys coriacea	41	2164778715	52799480.85	137568771	169519089.05	5	354452888	4772	709	2159184103	3045393.66	7029801	8982364.62	89	27993706	40	668	5594612	8375.17	87240	87449.98	25	153563	8	611488743:468001765:468035719:611657876	43.35	728247136	709	2159184103	3045393.66	668	41
GCA_028017835.1	rEmyOrb1	Emys orbicularis	106	2309740635	21790005.99	146456333	179851566.21	5	373885020	16962	254	2306416405	9080379.55	91255289	85606823.06	9	176114710	16962	148	3324230	22461.01	239976	240374.57	5	462822	13	637233251:516209752:515650131:637323271	44.74	804419438	254	2306416405	9080379.55	148	106
GCA_027887155.1	rMalTer1	Malaclemys terrapin	76	2211221380	29095018.16	144565223	173680106.48	5	356035893	10936	217	2209471813	10181897.76	75591180	71338515.11	11	138109357	10936	141	1749567	12408.28	383135	328080.17	2	582569	13	613741279:491178199:491132078:613420257	44.46	732773386	217	2209471813	10181897.76	141	76
GCA_045781085.1	rPanTec1	Pangshura tecta	449	2174585695	4843175.27	135935731	167524831.43	5	354212379	13735	709	2174533695	3067043.29	58728674	65410771.52	12	189234059	13735	260	52000	200.00	200	200.00	130	200	200	605577845:480654776:481877958:606423116	44.26	695854708	709	2174533695	3067043.29	260	449
GCA_032164245.1	rSteOdo2_p1.0	Sternotherus odoratus	218	1759411633	8070695.56	108345705	144429373.08	5	306559226	15166	771	1759301033	2281843.10	17031157	29330391.60	23	111721228	15166	553	110600	200.00	200	200.00	277	200	200	487234789:392026727:392309770:487729747	44.58	524038049	771	1759301033	2281843.10	553	218
GCA_007399415.1	rGopEvg1	Gopherus evgoodei	383	2298564209	6001473.13	147425149	177563723.12	5	370335144	5793	945	2269003890	2401062.32	12863190	16497608.78	52	62804385	1	562	29560319	52598.43	796286	1115874.14	10	3059779	1	633747107:500732402:500740158:633784223	44.14	752829714	945	2269003890	2401062.32	562	383
GCA_025201925.1	rGopFla2	Gopherus flavomarginatus	622	2460558587	3955881.97	162938067	191974041.56	5	380496693	1171	2488	2370920125	952942.17	6917139	9102287.11	96	43872830	14	1866	89638462	48037.76	345486	457803.29	78	1807615	4	655653381:529786609:529719108:655761027	44.69	838432467	2488	2370920125	952942.17	1866	622
GCA_040894355.2	rMyuGeo1	Myuchelys georgesi	109	1980039302	18165498.18	123447689	153727586.26	5	311452600	4000	186	1980023902	10645289.80	56181416	60515144.65	12	121452674	4000	77	15400	200.00	200	200.00	39	200	200	562196516:427857993:427630757:562338636	43.21	513516168	186	1980023902	10645289.80	77	109
GCA_045364815.1	rPodExp1	Podocnemis expansa	725	2565358608	3538425.67	300517188	267618792.50	4	435504880	1000	949	2565313808	2703175.77	24087131	30118886.30	32	71726202	1000	224	44800	200.00	200	200.00	112	200	200	715628856:569215699:565810798:714658455	44.25	855938152	949	2565313808	2703175.77	224	725
GCA_035149785.1	rCanAsp1	Candoia aspera	150	1530827941	10205519.61	209480725	188784683.78	3	343993754	1000	251	1530807741	6098835.62	55640180	65610401.75	9	165641000	1000	101	20200	200.00	200	200.00	51	200	200	451219564:314390544:314246548:450951085	41.07	506000891	251	1530807741	6098835.62	101	150
GCA_030867105.1	rLiaOli1	Liasis olivaceus	43	1486119866	34560927.12	203662644	184988443.27	3	332077321	11843	116	1485822150	12808811.64	65226870	76352614.06	8	203662644	11843	73	297716	4078.30	188868	122550.60	1	188868	13	444205699:298576045:298696409:444343997	40.20	440790352	116	1485822150	12808811.64	73	43
GCA_024294585.1	rVipLat1	Vipera latastei	56	1631568913	29135159.16	222489854	209533661.75	3	370625026	17313	825	1628021246	1973359.09	44839567	51385220.16	11	136351795	10079	769	3547667	4613.35	26592	36996.81	38	132685	13	480555638:333517548:333304619:480643441	40.96	721437013	825	1628021246	1973359.09	769	56
GCA_947247035.1	rVipUrs1	Vipera ursinii	384	1625023540	4231832.14	212821320	198305116.18	3	359753992	1000	2203	1624659740	737476.05	2137891	2709639.09	215	12662354	1000	1819	363800	200.00	200	200.00	910	200	200	480184006:332638650:332381887:479455197	40.93	727584680	2203	1624659740	737476.05	1819	384
GCA_964194415.1	rVipBer3	Vipera berus	479	1695017208	3538658.05	218396773	196366111.62	3	362934503	1000	1536	1694805808	1103389.20	4688414	5741619.53	108	23283494	1000	1057	211400	200.00	200	200.00	529	200	200	499358982:348302169:348169532:498975125	41.09	768854987	1536	1694805808	1103389.20	1057	479
GCA_009769535.1	rThaEle1	Thamnophis elegans	365	1672190305	4581343.30	100851885	114318965.26	6	186725308	616	1883	1634004602	867766.65	4620601	7583972.56	83	28276489	111	1518	38185703	25155.27	193953	321076.15	48	1336670	12	482321567:334547041:334612461:482523533	40.95	702622287	1883	1634004602	867766.65	1518	365
GCA_964273705.1	rNatHel1	Natrix helvetica	487	1777516490	3649931.19	172830377	203971522.60	4	376816054	1000	2497	1777114490	711699.84	1870695	2468923.95	266	11032010	1000	2010	402000	200.00	200	200.00	1005	200	200	517751106:370352668:370710615:518300101	41.70	809305022	2497	1777114490	711699.84	2010	487
GCA_031021105.1	rEryReg1	Erythrolamprus reginae	400	1964049041	4910122.60	259117534	235343916.22	3	426559836	1000	1791	1963770841	1096466.13	3064756	4299681.78	172	16736476	1000	1391	278200	200.00	200	200.00	696	200	200	576922689:404954894:405132830:576760428	41.25	1036195077	1791	1963770841	1096466.13	1391	400
GCA_037176765.1	rAnoSag1	Anolis sagrei	29	1950830970	67270033.45	249210491	223561313.73	4	345351809	15578	220	1950792770	8867239.86	43146625	47117479.37	14	130602597	15578	191	38200	200.00	200	200.00	96	200	200	572400520:402820332:403114891:572457027	41.31	878661096	220	1950792770	8867239.86	191	29
GCA_047715975.1	rBraPum1	Bradypodion pumilum	73	2467904324	33806908.55	387402510	356979774.87	3	523729189	23047	182	2467882524	13559794.09	44366450	51369677.98	18	123442637	23047	109	21800	200.00	200	200.00	55	200	200	678650256:555297710:554608635:679325923	44.97	1379902337	182	2467882524	13559794.09	109	73
GCA_030440675.1	rFurPar1	Furcifer pardalis	11	1609777135	146343375.91	184669281	201941111.89	4	317477549	17803144	23	1609766112	69989830.96	158731830	147483923.96	4	292066526	1917703	12	11023	918.58	1000	997.96	6	1000	23	467135597:337700089:337760843:467169583	41.96	668985360	23	1609766112	69989830.96	12	11
GCA_030412105.1	rCycPin1	Cyclura pinguis	30	1983631412	66121047.07	291724653	260116832.00	3	392530567	16631	58	1982549248	34181883.59	112814430	111112895.99	7	196623253	16631	28	1082164	38648.71	828982	651385.18	1	828982	13	578912822:412786019:412377131:578473276	41.62	635161553	58	1982549248	34181883.59	28	30
GCA_023053635.2	rElgMul1	Elgaria multicarinata webbii	35	1790519499	51157699.97	121985326	127614644.54	6	220126562	12108	108	1790506799	16578766.66	85762895	76953367.51	8	153590138	12108	73	12700	173.97	200	185.04	32	200	100	506051875:389356489:389814490:505283945	43.52	715990190	108	1790506799	16578766.66	73	35
GCA_029215775.1	rAnnSte1	Anniella stebbinsi	134	1890507581	14108265.53	275917861	286712641.21	3	424413838	12895	155	1890505481	12196809.55	120109455	144325361.05	5	280985737	12895	21	2100	100.00	100	100.00	11	100	100	532027977:413001293:413308012:532168199	43.71	734045188	155	1890505481	12196809.55	21	134
GCA_021292165.1	rShiCro1	Shinisaurus crocodilurus	1553	2189995079	1410170.69	296945371	213535249.94	4	321223554	1560	2405	2189909879	910565.44	3338364	4261531.47	196	30777962	1560	852	85200	100.00	100	100.00	426	100	100	603474197:491458716:491318509:603658457	44.88	936503049	2405	2189909879	910565.44	852	1553
GCA_009819535.1	rLacAgi1	Lacerta agilis	29	1391406172	47979523.17	86565987	86267453.61	7	133750839	7832	408	1387915094	3401752.68	6613248	9763086.23	57	37748703	891	379	3491078	9211.29	110865	236614.39	8	665664	13	390378453:303624186:303576818:390335637	43.75	473818426	408	1387915094	3401752.68	379	29
GCA_963506605.1	rZooViv1	Zootoca vivipara	49	1440256436	29392988.49	96056580	88978381.29	7	135718641	7000	732	1440119836	1967376.83	3447840	4348997.21	122	12667073	7000	683	136600	200.00	200	200.00	342	200	200	403009191:317163828:317255378:402691439	44.05	535447940	732	1440119836	1967376.83	683	49
GCA_027172205.1	rPodRaf1	Podarcis raffonei	27	1513131503	56041907.52	93623253	90718876.90	7	139138986	358	57	1513108387	26545761.18	61439401	62625318.64	10	104751829	358	30	23116	770.53	6169	5551.31	2	9101	23	425652288:331473293:331350305:424632501	43.81	572535690	57	1513108387	26545761.18	30	27
GCA_951804945.1	rPodCre2.1	Podarcis cretensis	51	1507627055	29561314.80	94621998	92835346.36	7	141635579	17088	98	1507617655	15383853.62	65743000	67229247.03	8	141635579	17088	47	9400	200.00	200	200.00	24	200	200	423121495:330614264:330843683:423038213	43.87	576157033	98	1507617655	15383853.62	47	51
GCA_964188175.1	rPodSic1	Podarcis siculus	294	1571381643	5344835.52	94541350	86696623.92	7	137310647	1000	1056	1571229243	1487906.48	3060007	3742525.38	160	16496121	1000	762	152400	200.00	200	200.00	381	200	200	437886598:348958993:347374399:437009253	44.32	627526299	1056	1571229243	1487906.48	762	294
GCA_964188315.1	rPodMur119	Podarcis muralis	185	1522641370	8230493.89	91987695	89980639.16	7	137271248	1000	1012	1522475970	1504422.90	3229453	3929026.33	147	18850722	1000	827	165400	200.00	200	200.00	414	200	200	424361088:336765179:336689648:424660055	44.23	567104476	1012	1522475970	1504422.90	827	185
GCA_964188305.1	rPodBoc1	Podarcis bocagei	507	1615206822	3185812.27	94948854	88992704.82	8	142668688	1000	1512	1615005807	1068125.53	2681335	3425874.33	178	17939469	1000	1005	201015	200.01	200	200.02	503	215	200	449622048:358284551:358138739:448960469	44.36	660956047	1512	1615005807	1068125.53	1005	507
GCA_964106915.2	rPodGai1	Podarcis gaigeae	211	1514643635	7178405.85	91932266	89447334.50	7	138852535	1000	1094	1514467035	1384339.15	2858450	3402672.40	165	10336902	1000	883	176600	200.00	200	200.00	442	200	200	425559023:331713013:331903403:425291596	43.82	572048475	1094	1514467035	1384339.15	883	211
GCA_964106645.2	rPodPit1	Podarcis pityusensis	336	1515373509	4510040.21	91584625	88804632.05	7	139677321	1000	1842	1515072309	822514.83	1611619	2023802.08	280	8320037	1000	1506	301200	200.00	200	200.00	753	200	200	424218376:333082572:333181656:424589705	43.98	569258491	1842	1515072309	822514.83	1506	336
GCA_964252035.1	rPodErh1	Podarcis erhardii	326	1495994634	4588940.60	93518625	90113069.07	7	140107003	1000	1162	1495827434	1287286.95	3226442	3819766.34	146	15006460	1000	836	167200	200.00	200	200.00	418	200	200	420513173:327486532:327663264:420164465	43.80	570202673	1162	1495827434	1287286.95	836	326
GCA_964234715.1	rPodMel1	Podarcis melisellensis	386	1574923724	4080113.27	91073809	84503716.71	8	136756110	1000	1209	1574759124	1302530.29	3027832	3825916.96	151	13723431	1000	823	164600	200.00	200	200.00	412	200	200	440933490:350453846:342907713:440464075	44.03	625431772	1209	1574759124	1302530.29	823	386
GCA_964270895.1	rPodFil1	Podarcis filfolensis	349	1506966124	4317954.51	91563485	87487007.25	7	136390025	1000	1221	1506791724	1234063.66	3042058	4055273.35	141	17513984	1000	872	174400	200.00	200	200.00	436	200	200	423691689:329994949:329831462:423273624	43.79	564959872	1221	1506791724	1234063.66	872	349
GCA_965112155.1	rPodLio1	Podarcis liolepis	290	1574020868	5427658.17	95422932	88055101.97	7	139441615	1000	1211	1573836668	1299617.40	2883979	3351220.08	172	12631870	1000	921	184200	200.00	200	200.00	461	200	200	440058743:346652214:346724603:440401108	44.06	622738483	1211	1573836668	1299617.40	921	290
GCA_965113315.1	rPodVau1	Podarcis vaucheri	285	1614928384	5666415.38	99219926	93249391.22	7	141902957	1000	1234	1614738584	1308540.18	2971493	3609242.90	165	15013544	1000	949	189800	200.00	200	200.00	475	200	200	450310362:357381128:356828232:450218862	44.23	657233103	1234	1614738584	1308540.18	949	285
GCA_965153285.1	rPodTil1	Podarcis tiliguerta	258	1462327121	5667934.58	89160134	86585639.72	7	135084514	1000	1282	1462122321	1140501.03	2556791	3109762.24	174	11282361	1000	1024	204800	200.00	200	200.00	512	200	200	409113513:321978619:322001632:409028557	44.04	531378258	1282	1462122321	1140501.03	1024	258
GCA_030035675.1	rRhiFlo1	Rhineura floridana	77	2307436586	29966708.91	188683971	176780754.02	5	323582766	15789	319	2300970302	7213073.05	18156940	23326162.38	38	75372028	15789	242	6466284	26720.18	136576	411947.62	9	1381917	13	657155668:493177272:493053983:657583379	42.86	1034113648	319	2300970302	7213073.05	242	77
GCA_023333525.2	rAspTig1	Aspidoscelis tigris stejnegeri	186	1673115766	8995246.05	115489130	145761944.05	5	296624713	12363	296	1673104766	5652380.97	41557363	43531843.05	14	87479529	8886	110	11000	100.00	100	100.00	55	100	100	474400103:362075351:361980193:474649119	43.28	646686922	296	1673104766	5652380.97	110	186
GCA_035046505.1	rTilSci1	Tiliqua scincoides	350	1623332312	4638092.32	242160784	201114567.11	3	314321002	14015	722	1623257912	2248279.66	33113817	41456320.01	14	102907154	14015	372	74400	200.00	200	200.00	186	200	200	448486449:363050094:362992451:448728918	44.73	592456251	722	1623257912	2248279.66	372	350
GCA_029931775.1	rEulEur1	Euleptes europaea	592	1781933648	3010023.05	102317683	100709201.84	7	183506054	1000	745	1777888608	2386427.66	26991305	32876225.90	20	98702465	1000	153	4045040	26438.17	109575	163586.28	10	499096	13	491544428:396820787:397531124:491992269	44.68	700635645	745	1777888608	2386427.66	153	592
GCA_028583425.1	rEubMac1	Eublepharis macularius	75	2237379946	29831732.61	145573841	153888937.82	6	255159772	11877	136	2237373846	16451278.28	80105973	92335505.38	9	188850699	11877	61	6100	100.00	100	100.00	31	100	100	626144505:492859164:492911849:625458328	44.06	836940614	136	2237373846	16451278.28	61	75
GCA_046126795.1	rDibSmi1	Dibamus smithi	327	2282721590	6980799.97	146217707	161316072.93	6	301686990	9686	601	2282666790	3798114.46	18158878	23810694.13	34	66036565	9686	274	54800	200.00	200	200.00	137	200	200	616382261:524168594:524798249:617317686	45.95	995103385	601	2282666790	3798114.46	274	327
GCA_027410445.1	aDisPic1	Discoglossus pictus	1318	3872602052	2938241.31	453717995	356795198.55	4	567555107	202	4999	3810206057	762193.65	3043591	4820392.19	313	29500793	18	3681	62395995	16950.83	246075	274335.53	84	981195	13	1152169065:753037684:752871126:1152128182	39.52	2102916101	4999	3810206057	762193.65	3681	1318
GCA_027579735.1	aBomBom1	Bombina bombina	2468	10019681242	4059838.43	1241340601	1132019076.89	4	1601664463	711	9477	9820783065	1036275.52	3712229	4838402.37	740	24459601	305	7009	198898177	28377.54	205962	309334.13	263	1804498	1	2996997848:1914350997:1913749910:2995684310	38.98	6328435901	9477	9820783065	1036275.52	7009	2468
GCA_964205295.1	aBomVar4	Bombina variegata	4757	9369791316	1969684.95	1114117749	937762773.06	4	1415942608	1000	11428	9368457116	819780.99	1741680	2140968.68	1632	13204228	1000	6671	1334200	200.00	200	200.00	3336	200	200	2861502359:1823802298:1823303245:2859849214	38.93	6162768768	11428	9368457116	819780.99	6671	4757
GCA_037306005.1	aRhiDor1	Rhinophrynus dorsalis	464	4745569335	10227520.12	565843407	503094041.78	4	702319255	14628	2496	4745162916	1901106.94	12994863	18775828.58	92	94607629	14628	2032	406419	200.01	200	200.01	1016	219	200	1377750539:995340693:994856193:1377215491	41.94	2509418361	2496	4745162916	1901106.94	2032	464
GCA_040206685.1	aAscTru1	Ascaphus truei	3549	3722616900	1048919.95	424004025	295910019.52	4	555822420	6931	9569	3721412824	388903.00	981472	1388351.26	1005	6913250	6931	6020	1204076	200.01	200	200.02	3010	276	200	1024626642:834772192:836744412:1025269578	44.92	2031833847	9569	3721412824	388903.00	6020	3549
GCA_036172605.1	aPelFus1	Pelobates fuscus	160	3606474367	22540464.79	387735018	338954054.63	5	499470508	1000	509	3606404741	7085274.54	29412599	34225876.44	37	94952142	1000	349	69626	199.50	200	199.94	175	200	26	1046145103:758137304:757965053:1044157281	42.04	1827037582	509	3606404741	7085274.54	349	160
GCA_036172795.1	aPelIbe1	Pelodytes ibericus	99	2077659799	20986462.62	222280400	201063630.12	5	302547531	8000	361	2077607399	5755145.15	19137354	25982099.39	30	94589335	8000	262	52400	200.00	200	200.00	131	200	200	625858122:413064961:412442061:626242255	39.73	1007204234	361	2077607399	5755145.15	262	99
GCA_027358695.2	aSpeBom1	Spea bombifrons	17	987655159	58097362.29	114150385	103637497.89	4	165483513	24339	119	983832516	8267500.13	21170366	34949156.55	10	90256550	24339	102	3822643	37476.89	805906	1008732.72	2	1740727	13	293190719:199097608:198838621:292705568	40.45	350566278	119	983832516	8267500.13	102	17
GCA_038501925.1	aXenPet1	Xenopus petersii	888	2883796191	3247518.23	160347489	161111582.48	8	241009896	11070	1388	2883696191	2077590.92	15294995	17422724.67	57	46795836	11070	500	100000	200.00	200	200.00	250	200	200	872141129:569778030:569964448:871812584	39.52	1294592026	1388	2883696191	2077590.92	500	888
GCA_035609145.1	aEleCoq1	Eleutherodactylus coqui	957	3371316047	3522796.29	277440397	280972624.91	5	538120716	10585	1616	3371184247	2086128.87	10388966	14867484.37	89	82819733	10585	659	131800	200.00	200	200.00	330	200	200	928232181:756204829:757646775:929100462	44.91	1801942267	1616	3371184247	2086128.87	659	957
GCA_040937935.1	aHypRig1	Hyperolius riggenbachi	477	4915935452	10305944.34	451034413	445625376.30	5	691750716	13383	3516	4915328756	1397988.84	2674826	3455693.84	544	19566916	1	3039	606696	199.64	200	199.94	1517	236	29	1352211706:1105179439:1105719431:1352218180	44.98	2935732164	3516	4915328756	1397988.84	3039	477
GCA_905171765.1	aBufBuf1	Bufo bufo	1307	5044762059	3859802.65	635713434	602238362.60	4	843366180	472	5506	5034883801	914435.85	3941737	5304968.51	351	23035304	25	4199	9878258	2352.53	80496	125164.09	27	351611	5	1397343779:1120265202:1119879273:1397395547	44.49	3136518375	5506	5034883801	914435.85	4199	1307
GCA_027789765.1	aDenEbr1	Dendropsophus ebraccatus	2200	2214937069	1006789.58	153439414	147634356.34	6	234432908	1005	3004	2208244125	735101.24	8808153	11934000.47	65	53828024	157	804	6692944	8324.56	117741	191823.17	14	625918	7	618648332:485629094:485242017:618724682	43.97	1119187375	3004	2208244125	735101.24	804	2200
GCA_029499605.1	aHylSar1	Hyla sarda	3475	4142177554	1191993.54	384967061	352847123.15	5	620771670	1000	5772	4141718327	717553.42	3809262	5899666.72	271	41226019	1000	2297	459227	199.92	200	199.99	1149	200	27	1161729911:908616951:909402277:1161969188	43.90	2634831157	5772	4141718327	717553.42	2297	3475
GCA_032444005.1	aRanImi1	Ranitomeya imitator	1673	5956630009	3560448.30	725832262	761348037.94	4	1253408930	3401	2438	5956549850	2443211.59	13907627	17717486.28	124	74600702	19	765	80159	104.78	100	110.31	358	200	27	1641295119:1338253087:1339214669:1637786975	44.95	4268312094	2438	5956549850	2443211.59	765	1673
GCA_048569485.1	aAnoBae1	Anomaloglossus baeobatrachus	3642	6265077250	1720229.89	707508717	579433485.12	4	977094522	2321	7414	6264336818	844933.48	2835192	3682424.38	626	19010593	2007	3772	740432	196.30	200	198.16	1851	249	26	1683122115:1448768658:1449703488:1682742557	46.27	4333931281	7414	6264336818	844933.48	3772	3642
GCA_040894005.1	aEngPut4	Engystomops pustulosus	936	2158203323	2305772.78	214838416	202936519.86	5	306306954	9961	1372	2158116123	1572970.94	21805561	27606712.49	27	76977749	9961	436	87200	200.00	200	200.00	218	200	200	613682088:466579357:465557897:612296781	43.19	1117374380	1372	2158116123	1572970.94	436	936
GCA_031893055.1	aLepFus1	Leptodactylus fuscus	1266	2197996823	1736174.43	226021100	216120424.87	4	371056122	11319	2242	2177615064	971282.37	5334240	7138233.30	108	29677041	11319	976	20381759	20882.95	234023	332200.66	24	1281072	13	620657651:467117627:468441448:621398338	42.96	1169486263	2242	2177615064	971282.37	976	1266
GCA_028390025.1	aPseCor3	Pseudophryne corroboree	3127	8872758793	2837466.83	846894890	759570167.99	5	1251518389	1000	5826	8851546336	1519317.94	6819095	9436278.36	353	49049723	159	2699	21212457	7859.38	79020	103295.91	80	428545	13	2404300706:2019606578:2022065487:2405573565	45.66	6273008921	5826	8851546336	1519317.94	2699	3127
GCA_038048845.1	aMixFle1	Mixophyes fleayi	2806	2969628263	1058313.71	346624570	276278104.77	4	463649476	10329	4227	2965826130	701638.55	4050021	5274378.39	203	23175378	1	1421	3802133	2675.67	45788	74626.98	19	219021	13	885267041:597760278:598041340:884757471	40.32	1358710569	4227	2965826130	701638.55	1421	2806
GCA_027917425.1	aGasCar1	Gastrophryne carolinensis	1002	4336248441	4327593.25	489283037	456810144.44	4	660159871	1000	2747	4335899441	1578412.61	4962642	6467288.84	248	31750250	1000	1745	349000	200.00	200	200.00	873	200	200	1155368530:1014030758:1014134066:1152366087	46.78	2592327746	2747	4335899441	1578412.61	1745	1002
GCA_048565345.1	aManAur1	Mantella aurantiaca	3088	3336112499	1080347.31	333086339	297054611.77	5	505206504	2278	7226	3335285250	461567.29	2265415	3007557.16	401	21879361	1	4138	827249	199.92	200	199.99	2069	200	21	983779221:684823455:682639318:984043256	41.00	1725254883	7226	3335285250	461567.29	4138	3088
GCA_905171775.1	aRanTem1	Rana temporaria	555	4111445260	7408009.48	481763206	410025773.70	4	690654357	563	2415	4085251226	1691615.41	6262427	7684950.53	197	39532736	100	1860	26194034	14082.81	318586	652930.78	17	2218725	4	1140895443:901509422:902139761:1140706600	44.15	2244424266	2415	4085251226	1691615.41	1860	555
GCA_965119305.1	aPelLes1	Pelophylax lessonae	1328	5811246175	4375938.38	677924506	551095044.76	4	896647653	1000	4372	5810637375	1329057.04	3786355	4725461.11	455	29469752	1000	3044	608800	200.00	200	200.00	1522	200	200	1634212984:1270439657:1271661991:1634322743	43.75	3456020913	4372	5810637375	1329057.04	3044	1328
GCA_040938575.1	aAmbMet2	Ambystoma mexicanum x Ambystoma tigrinum	220	29117848270	132353855.77	1489131749	1406365793.50	10	1740248193	19791	2315	29117430970	12577723.96	23068610	28098197.04	384	120835383	19791	2095	417300	199.19	200	199.59	1044	200	100	7811934983:6745963420:6746276474:7813256093	46.34	14479815520	2315	29117430970	12577723.96	2095	220
GCA_026652325.1	aPleWal1	Pleurodeles waltl	267	20300798037	76032951.45	1237754594	1344254810.81	7	1917772152	3357	1189	20300464995	17073561.81	45590032	60679906.99	125	222933365	3357	922	333042	361.22	500	408.13	333	740	240	5485693136:4662639597:4664470529:5487661733	45.95	11369904792	1189	20300464995	17073561.81	922	267
GCA_964204655.1	aTriCri1	Triturus cristatus	1304	22324633092	17120117.40	1248769876	1342719344.23	8	1950672471	1000	6002	22323693492	3719375.79	8497210	10291941.19	808	53546240	1000	4698	939600	200.00	200	200.00	2349	200	200	6080005549:5077768453:5085434705:6080484785	45.53	11257114781	6002	22323693492	3719375.79	4698	1304
GCA_964263255.1	aLisVul1	Lissotriton vulgaris	15265	24226223864	1587043.82	1925992481	1527463911.26	6	2145962954	1000	19295	24225418039	1255528.27	6568731	7923203.85	1102	34933532	1000	4030	805825	199.96	200	199.99	2015	200	25	6654736994:5456698845:5458968591:6655013609	45.06	11408787683	19295	24225418039	1255528.27	4030	15265
GCA_964261635.1	aLisHel1	Lissotriton helveticus	448	23170028842	51718814.38	2132484007	1752204110.85	6	2146314909	1000	5693	23168979842	4069731.22	7795245	9272526.26	941	47371485	1000	5245	1049000	200.00	200	200.00	2623	200	200	6361577644:5224285306:5221697065:6361419827	45.09	10914828389	5693	23168979842	4069731.22	5245	448
GCA_901001135.2	aRhiBiv1	Rhinatrema bivittatum	1330	5319239186	3999427.96	486875112	485923529.76	4	839681426	120	4903	5285283346	1077969.27	3216284	3943941.11	489	16348592	52	3573	33955840	9503.45	136639	199887.02	67	771063	4	1469234858:1173353317:1173212914:1469482257	44.40	2309964629	4903	5285283346	1077969.27	3573	1330
GCA_901765095.2	aMicUni1	Microcaecilia unicolor	1081	4685939421	4334819.08	376147139	436672789.66	4	772932187	2048	3533	4638502143	1312907.48	3650988	4817809.11	367	33608330	221	2452	47437278	19346.36	466451	724023.40	25	2824530	1	1298410461:1020712314:1020834581:1298544787	44.01	2430189469	3533	4638502143	1312907.48	2452	1081
GCA_902459505.2	aGeoSer1	Geotrypetes seraphini	164	3779430017	23045304.98	272612222	317611545.62	5	550518975	2393	597	3773927304	6321486.27	20656571	27030387.45	53	104402355	405	433	5502713	12708.34	112069	158328.68	13	430889	13	1071037292:815791260:815981822:1071116930	43.24	1971591364	597	3773927304	6321486.27	433	164
GCA_900747795.4	fErpCal1.3	Erpetoichthys calabaricus	169	3613551089	21381959.11	217689105	235383332.76	6	356776219	1796	1600	3583843432	2239902.15	6772339	8648849.23	155	31810781	263	1431	29707657	20760.07	204732	277465.47	37	960416	13	1086501587:705557342:705348323:1086436180	39.37	1701508834	1600	3583843432	2239902.15	1431	169
GCA_902713425.2	fAciRut3	Acipenser ruthenus	1731	1899810788	1097522.12	42723358	56084165.05	12	120284971	9126	2164	1899724488	877876.38	8776027	10180590.73	65	31312220	9126	433	86300	199.31	200	199.65	216	200	100	568726504:380594877:381406271:568996836	40.11	781840306	2164	1899724488	877876.38	433	1731
GCA_036373705.1	fAmiCal2	Amia calva	390	989120851	2536207.31	44181238	41418101.42	10	64379224	4190	487	989101451	2031009.14	17465777	17537303.51	20	37401183	4190	97	19400	200.00	200	200.00	49	200	200	293178870:201680863:201414229:292827489	40.75	365899834	487	989101451	2031009.14	97	390
GCA_040954835.1	fLepOcu1	Lepisosteus oculatus	817	1200606178	1469530.21	47769348	45020380.75	10	78916909	15282	912	1200587178	1316433.31	20019514	20884767.73	20	52296021	15282	95	19000	200.00	200	200.00	48	200	200	356051735:243723699:244414531:356397213	40.66	450891160	912	1200587178	1316433.31	95	817
GCA_013368585.1	fMegCyp1	Megalops cyprinoides	207	959258777	4634100.37	38251172	41592623.48	10	74015632	15262	270	958975679	3551761.77	26850664	27964021.76	13	65828915	3657	63	283098	4493.62	73481	84129.75	2	127060	13	273170416:206341661:206242077:273221525	43.02	204710499	270	958975679	3551761.77	63	207
GCA_013347855.1	fAngAng1	Anguilla anguilla	53	979029243	18472249.87	57205429	57127856.57	7	88055840	7279	693	975160744	1407158.36	5114673	6636859.08	54	23793964	555	640	3868499	6044.53	142494	156039.37	10	397544	9	274893768:212700238:212840220:274726518	43.64	257515586	693	975160744	1407158.36	640	53
GCA_963514075.1	fConCon1	Conger conger	381	1136421744	2982734.24	64882367	62956130.29	8	96783005	1000	1390	1136219944	817424.42	3090688	3902243.74	105	14074610	1000	1009	201800	200.00	200	200.00	505	200	200	318904645:249769123:248964474:318581702	43.89	389937519	1390	1136219944	817424.42	1009	381
GCA_900964775.1	fSclFor1	Scleropages formosus	71	784546363	11049948.77	31084684	32733141.32	11	54115380	23590	216	784505003	3631967.61	9102216	9472590.53	31	24226940	2021	145	41360	285.24	500	5825.89	6	14756	13	218883454:173235153:173217380:219169016	44.16	204020021	216	784505003	3631967.61	145	71
GCA_900700375.2	fDenClu1	Denticeps clupeoides	461	567417970	1230841.58	22793177	25377924.10	9	42171479	8882	925	562769583	608399.55	3059612	3653736.25	53	11643062	193	464	4648387	10018.08	189773	236768.78	8	518837	13	158555667:122939828:122914339:158359749	43.69	159692746	925	562769583	608399.55	464	461
GCA_018492685.1	fAloSap1	Alosa sapidissima	73	903564947	12377602.01	38440066	37957633.64	11	56504578	2376	1712	898569135	524865.15	1565278	2070271.81	165	12180528	2376	1639	4995812	3048.09	20007	52952.94	59	368186	13	255331168:194056410:193903449:255278108	43.18	344765054	1712	898569135	524865.15	1639	73
GCA_963457725.1	fSprSpr1	Sprattus sprattus	387	840332306	2171401.31	33839184	43576246.75	9	78916084	1000	1888	840032080	444932.25	1216682	1732233.45	186	7550000	1000	1501	300226	200.02	200	200.02	751	226	200	235627376:184248296:183963605:236192803	43.83	287030006	1888	840032080	444932.25	1501	387
GCA_963854185.1	fSarPil1	Sardina pilchardus	241	869414035	3607527.12	34617450	35724230.93	12	52055910	1000	1895	869083235	458619.12	1117303	1482715.97	218	5923256	1000	1654	330800	200.00	200	200.00	827	200	200	241401948:193131245:193124516:241425526	44.44	315551505	1895	869083235	458619.12	1654	241
GCA_048544225.1	fColCha1	Coilia mystus	184	854254650	4642688.32	34984248	34486260.27	12	45051600	1000	1316	854141450	649043.66	1817416	2986859.97	112	15185573	757	1132	113200	100.00	100	100.00	566	100	100	239008306:187942439:187813593:239377112	43.99	314318903	1316	854141450	649043.66	1132	184
GCA_902362185.1	fChaCha1	Chanos chanos	30	656912816	21897093.87	50300218	46715533.73	6	63121898	21534	141	652682485	4628953.79	23134051	20823926.71	11	43225175	1594	111	4230331	38111.09	2319715	1919627.50	1	2319715	13	190713627:135533910:135529798:190905150	41.53	167326287	141	652682485	4628953.79	111	30
GCA_944039275.1	fDanRer4	Danio rerio	73	1413675870	19365422.88	58626443	57898838.78	11	79028891	9269	454	1413553475	3113553.91	6927137	9094173.99	59	28607879	9269	381	122395	321.25	500	392.27	123	500	17	444984884:262864655:261216670:444487266	37.08	715877321	454	1413553475	3113553.91	381	73
GCA_949152265.1	fPhoPho1	Phoxinus phoxinus	125	950498056	7603984.45	36753459	39085546.16	11	55893807	1000	1006	950321856	944653.93	1988965	2525835.95	142	13105714	1000	881	176200	200.00	200	200.00	441	200	200	288662936:186371578:186243476:289043866	39.21	375408127	1006	950321856	944653.93	881	125
GCA_951802725.1	fRutRut2	Rutilus rutilus	85	1100195650	12943478.24	43935812	46488689.68	11	80293868	1000	556	1100101450	1978599.73	3932511	4386604.73	91	13821085	1000	471	94200	200.00	200	200.00	236	200	200	336701244:213412701:213441219:336546286	38.80	439694335	556	1100101450	1978599.73	471	85
GCA_949319135.1	fSquCep2.1	Squalius cephalus	106	1101930522	10395570.96	41795634	45505349.12	11	70742303	1000	694	1101812922	1587626.69	3040692	3409309.82	117	10981208	1000	588	117600	200.00	200	200.00	294	200	200	337311669:213196946:213525660:337778647	38.73	444784840	694	1101812922	1587626.69	588	106
GCA_936440315.1	fBarBab1	Barbus barbus	92	1584929904	17227498.96	31505967	32634560.90	22	47791430	12731	200	1584908304	7924541.52	22843665	20676259.29	29	40726689	12731	108	21600	200.00	200	200.00	54	200	200	492251731:300171720:300343361:492141492	37.89	655883181	200	1584908304	7924541.52	108	92
GCA_947034865.1	fBarBar1	Barbatula barbatula	100	617663352	6176633.52	24423978	25231642.41	12	36424156	1000	925	617498352	667565.79	2654543	3085774.62	72	13962000	1000	825	165000	200.00	200	200.00	413	200	200	186144591:122696392:122392563:186264806	39.69	207759015	925	617498352	667565.79	825	100
GCA_963993115.1	fAbrBra2.1	Abramis brama	208	1108218292	5327972.56	42794514	46846906.02	11	79936830	1000	893	1108081292	1240852.51	3478172	3784880.24	108	12857093	1000	685	137000	200.00	200	200.00	343	200	200	339982429:214009660:213901908:340187295	38.62	436748347	893	1108081292	1240852.51	685	208
GCA_964197995.1	fScaEry2	Scardinius erythrophthalmus	755	1229666150	1628696.89	44954600	47079346.88	11	80171683	1000	1591	1229498950	772783.75	2291051	2841895.32	157	9866000	1000	836	167200	200.00	200	200.00	418	200	200	375082890:239968508:239837529:374610023	39.02	531566949	1591	1229498950	772783.75	836	755
GCA_965113295.1	fLeuLeu2	Leuciscus leuciscus	876	1198377133	1368010.43	43730789	46798059.84	11	84825578	1000	2078	1198136733	576581.68	1661817	2212019.98	205	9432437	1000	1202	240400	200.00	200	200.00	601	200	200	365522016:233883265:233800621:364930831	39.03	495570234	2078	1198136733	576581.68	1202	876
GCA_949357685.1	fGobGob1	Gobio gobio	231	1460679231	6323286.71	58069932	58924150.73	11	87331821	1000	1277	1460470031	1143672.69	2576923	3197999.21	170	13998120	1000	1046	209200	200.00	200	200.00	523	200	200	440076769:290054937:290318919:440019406	39.74	791950386	1277	1460470031	1143672.69	1046	231
GCA_963082965.1	fCarcar2	Carassius carassius	278	1684313041	6058680.00	32663704	33768028.46	23	53933806	1000	1110	1684146641	1517249.23	3822391	4569296.53	135	15756000	1000	832	166400	200.00	200	200.00	416	200	200	519557907:322555204:322710076:519323454	38.31	735833105	1110	1684146641	1517249.23	832	278
GCA_038024135.1	fCypVen1	Cyprinella venusta	413	928717837	2248711.47	35217774	37227111.72	11	59110519	13508	1133	928583337	819579.29	1550857	2533198.03	160	13316459	163	720	134500	186.81	200	192.94	337	200	100	284255350:180507953:179716805:284103229	38.79	434216878	1133	928583337	819579.29	720	413
GCA_048301585.1	fRhiNas1	Rhinogobio nasutus	70	953377980	13619685.43	38227425	38654092.07	12	52118804	22807	72	953377780	13241358.06	38227425	38509834.89	12	52118804	22807	2	200	100.00	100	100.00	1	100	100	290892282:185676311:185778714:291030473	38.96	424188010	72	953377780	13241358.06	2	70
GCA_041902795.1	fEleEle2	Electrophorus electricus	460	833427914	1811799.81	30383234	28091923.86	11	45481281	520	509	831323697	1633248.91	22449376	21563395.01	15	40310652	520	49	2104217	42943.20	114918	114435.11	7	220612	10	242104441:173239150:173744786:242235320	41.74	286047319	509	831323697	1633248.91	49	460
GCA_015220715.1	fPygNat1	Pygocentrus nattereri	56	1222067157	21822627.80	42283192	42715037.07	13	57280940	2017	359	1211907973	3375788.23	12898870	14674333.55	29	32743256	139	303	10159184	33528.66	778504	778664.90	5	1440661	13	359983118:245819920:245957123:360147812	40.58	425374165	359	1211907973	3375788.23	303	56
GCA_029633855.2	fHopMal1	Hoplias malabaricus	597	1186354877	1987194.10	53138383	56903781.90	8	90976188	2000	1586	1121252936	706969.06	3626585	6608629.72	68	26945060	2000	989	65101941	65826.03	513542	1022320.67	27	3867415	13	330671434:229696905:229883830:331000767	40.99	434715998	1586	1121252936	706969.06	989	597
GCA_030463535.1	fSalBra1	Salminus brasiliensis	104	1066501646	10254823.52	40765202	46596068.00	11	99388286	17959	830	1057429429	1274011.36	5834861	7721175.83	47	23834934	17959	726	9072217	12496.17	79698	184762.13	23	764825	13	309186428:218138028:218525791:311579182	41.29	378769055	830	1057429429	1274011.36	726	104
GCA_023375975.1	fAstMex1	Astyanax mexicanus	109	1373169186	12597882.44	51923808	58104548.90	11	134019835	20700	123	1373162186	11163920.21	47087582	50288725.50	11	134019835	20700	14	7000	500.00	500	500.00	7	500	500	423692558:262500672:262536383:424432573	38.24	629760039	123	1373162186	11163920.21	14	109
GCA_946808225.1	fSilAri1	Silurus aristotelis	241	800118513	3319993.83	30578072	29035302.88	12	44060567	1000	1036	799959513	772161.69	4577990	5809939.39	49	19180065	1000	795	159000	200.00	200	200.00	398	200	200	243812899:155472355:155702361:244971898	38.90	327617615	1036	799959513	772161.69	795	241
GCA_027358585.1	fPanHyp1	Pangasianodon hypophthalmus	59	764990969	12965948.63	26128932	26883266.00	13	36215093	282	295	761110991	2580037.26	13007371	12357677.49	22	26025501	282	236	3879978	16440.58	118200	108271.43	14	227894	23	232483307:148468065:148265343:231894276	38.99	240208146	295	761110991	2580037.26	236	59
GCA_027579695.1	fNeoGra1	Neoarius graeffei	38	2341916362	61629377.95	83992109	89793933.29	11	131004987	29346	372	2328656222	6259828.55	14859289	17440767.81	50	61733323	15320	334	13260140	39701.02	1585142	1164669.10	4	2165723	13	670095048:494046118:494351735:670163321	42.44	1453063693	372	2328656222	6259828.55	334	38
GCA_030014385.1	fTriRos1	Trichomycterus rosablanca	349	1045025885	2994343.51	40419146	43519965.15	10	87397567	1000	547	1044986285	1910395.40	13074164	15907994.43	24	40042000	1000	198	39600	200.00	200	200.00	99	200	200	312233583:210546131:210254475:311952096	40.27	500997587	547	1044986285	1910395.40	198	349
GCA_024256435.1	fClaGar1	Clarias gariepinus	119	972641408	8173457.21	34021760	35373309.56	12	51775064	10904	299	972632893	3252952.82	32098287	30571942.15	13	43438653	1	180	8515	47.31	500	1062.36	4	2500	1	296559447:189542458:189544759:296986229	38.98	371017529	299	972632893	3252952.82	180	119
GCA_049190665.1	fLepSal2	Lepidogalaxias salamandroides	2987	735065728	246088.29	27841354	27527018.69	10	61963674	1907	4352	734796728	168841.16	776167	1258548.25	226	5807458	1416	1365	269000	197.07	200	198.51	673	200	100	202075064:165220547:165556935:201944182	45.02	289138381	4352	734796728	168841.16	1365	2987
GCA_951799395.1	fArgSil1	Argentina silus	1024	670765936	655044.86	24540466	27553068.30	10	54096584	1000	2776	670415536	241504.16	858168	1417770.19	188	7041626	1000	1752	350400	200.00	200	200.00	876	200	200	185153965:150096589:149938343:185226639	44.75	254680186	2776	670415536	241504.16	1752	1024
GCA_963989245.1	fNanAnt1	Nansenia antarctica	1177	1085794659	922510.33	66745282	61796023.38	7	114812566	1000	4476	1085134859	242434.06	750607	1062757.88	386	7084714	1000	3299	659800	200.00	200	200.00	1650	200	200	297632565:245130718:245517426:296854150	45.22	509313841	4476	1085134859	242434.06	3299	1177
GCA_017639675.1	fAplTae1	Aplochiton taeniatus	41	461946147	11266979.20	20392628	27405405.76	8	55692580	11237	1199	453790189	378473.89	956540	1155081.86	145	5282126	682	1158	8155958	7043.14	96592	117936.70	26	371799	13	124642904:102183268:102070952:124893065	45.01	122641767	1199	453790189	378473.89	1158	41
GCA_011004845.1	fEsoLuc1 	Esox lucius	53	918749000	17334886.79	37473588	38482820.48	11	55408060	3799	165	917726265	5561977.36	22630263	23514985.63	14	50352851	1675	112	1022735	9131.56	136030	147330.68	3	235536	13	265084683:193756820:193728407:265156355	42.22	290391356	165	917726265	5561977.36	112	53
GCA_901001165.2	fSalTru1	Salmo trutta	1441	2371880186	1645995.97	52209666	54602379.48	18	97529106	6004	5382	2298279481	427030.75	1692994	2959943.04	295	14403744	1	3941	73600705	18675.64	132444	197172.97	162	1160791	1	650731493:498042885:498445957:651059146	43.36	1206892863	5382	2298279481	427030.75	3941	1441
GCA_036784965.1	fSalAlp2	Salvelinus alpinus	1169	2129031653	1821241.79	58852000	77916444.91	10	218933541	13067	4404	2128384653	483284.44	1203068	1772941.84	463	9691759	1691	3235	647000	200.00	200	200.00	1618	200	200	601874697:460705840:462433137:603370979	43.37	1089122386	4404	2128384653	483284.44	3235	1169
GCA_964263955.1	fCorLav1	Coregonus lavaretus	11150	2842862595	254965.26	47422375	41075708.25	24	95564469	1000	17145	2841663595	165742.99	476628	841604.40	1337	4941238	1000	5995	1199000	200.00	200	200.00	2998	200	200	797552048:623735246:623005314:797370987	43.87	1715794762	17145	2841663595	165742.99	5995	11150
GCA_038355195.1	fOsmMor3	Osmerus mordax	365	497673479	1363488.98	18699972	17990281.92	12	26325141	13491	2272	497309279	218886.13	607895	1634704.72	157	8303878	164	1907	364200	190.98	200	195.28	911	200	100	135486188:113209959:113332638:135280494	45.55	167583137	2272	497309279	218886.13	1907	365
GCA_963692335.1	fOsmEpe2	Osmerus eperlanus	1008	508737883	504700.28	18633437	18083827.70	12	27410175	1000	3470	508245483	146468.44	396237	1008143.19	272	9150893	1000	2462	492400	200.00	200	200.00	1231	200	200	138808336:115385911:115433497:138617739	45.41	174600851	3470	508245483	146468.44	2462	1008
GCA_949987555.1	fBorAnt1	Borostomias antarcticus	1378	909249001	659832.37	27266006	25799547.99	14	61707914	1000	4009	908722801	226670.69	959230	1715344.37	219	9135858	1000	2631	526200	200.00	200	200.00	1316	200	200	242885700:209168679:211678099:244990323	46.31	407625918	4009	908722801	226670.69	2631	1378
GCA_963971535.1	fNotCoa1	Notolepis coatsi	5983	3427809033	572924.79	155911686	162674355.10	8	323290686	979	21096	3424788466	162343.03	444000	677647.57	1951	4549348	16	15113	3020567	199.87	200	200.01	7550	308	17	949087185:763343640:763067884:949289757	44.57	2295325637	21096	3424788466	162343.03	15113	5983
GCA_951216825.1	fEleAnt2	Electrona antarctica	1901	1427445741	750892.03	53633514	47867110.39	12	65725131	1000	5080	1426809941	280868.10	1002537	1561518.16	355	9567001	1000	3179	635800	200.00	200	200.00	1590	200	200	402504065:310909245:310809548:402587083	43.57	739931859	5080	1426809941	280868.10	3179	1901
GCA_964188405.1	fProPar1	Protomyctophum parallelum 	24	1235328005	51472000.21	53459825	57015380.58	10	108646427	18305	2753	1234782205	448522.41	1024588	1398908.06	336	6728559	18305	2729	545800	200.00	200	200.00	1365	200	200	352551792:265023134:264815703:352391576	42.91	583728972	2753	1234782205	448522.41	2729	24
GCA_963280865.1	fGymBra2	Gymnoscopelus braueri	676	1367984568	2023645.81	55139090	52353229.50	12	66258222	1000	3380	1367443768	404569.16	901999	1119982.16	454	5699719	1000	2704	540800	200.00	200	200.00	1352	200	200	395581804:288154396:288186082:395521486	42.15	667841804	3380	1367443768	404569.16	2704	676
GCA_963454915.1	fGymMic1	Gymnoscopelus microlampas	374	1318656016	3525818.22	55298648	53397833.19	12	65794246	1000	1772	1318376416	744004.75	1741000	2065112.62	240	9631340	1000	1398	279600	200.00	200	200.00	699	200	200	381194560:278202434:278123077:380856345	42.20	608905010	1772	1318376416	744004.75	1398	374
GCA_963921795.1	fNanAch1	Nannobrachium achirus	673	1658848640	2464856.82	66219085	66460446.84	12	90174274	1000	3070	1658369240	540185.42	1305851	1611351.40	384	8247971	1000	2397	479400	200.00	200	200.00	1199	200	200	475357266:353982759:353999854:475029361	42.69	883432297	3070	1658369240	540185.42	2397	673
GCA_963924005.1	fProBol1	Protomyctophum bolini	951	1148224649	1207386.59	45973806	43845890.66	12	57054109	1000	2736	1147867649	419542.27	1267060	1656714.34	254	7284828	1000	1785	357000	200.00	200	200.00	893	200	200	329450322:244514716:244595580:329307031	42.61	529580596	2736	1147867649	419542.27	1785	951
GCA_029633865.1	fLamInc1	Lampris incognitus	544	1482357630	2724922.11	62607046	79929945.38	8	155004971	12343	3659	1481734900	404956.24	917127	1749096.39	379	14060875	1031	3115	622730	199.91	200	200.00	1557	229	37	409153009:332438049:333522201:406621641	44.94	748142558	3659	1481734900	404956.24	3115	544
GCA_046255685.1	fAmbSpe1	Amblyopsis spelaea	892	817459139	916434.01	32241792	30689722.40	12	42231476	13962	1358	817365939	601889.50	4008197	5887399.15	51	22626708	13962	466	93200	200.00	200	200.00	233	200	200	236636788:172067297:171993584:236668270	42.09	358359525	1358	817365939	601889.50	466	892
GCA_960531495.1	fZeuFab8	Zeus faber	191	804731948	4213256.27	34476449	36490495.51	10	65762550	1000	1078	804554548	746340.03	1449431	1739522.54	171	6544643	1000	887	177400	200.00	200	200.00	444	200	200	225888322:176303407:177070620:225292199	43.92	309303903	1078	804554548	746340.03	887	191
GCA_902167405.1	fGadMor3	Gadus morhua	226	669949713	2964379.26	28732775	28503757.54	11	43798135	3512	1442	646375970	448249.63	1015663	1547879.95	169	7478355	1	1216	23573743	19386.30	98160	141322.01	68	609820	1	175764735:147587624:147440825:175582786	45.64	212669140	1442	646375970	448249.63	1216	226
GCA_949987615.1	fPolPol2.1	Pollachius pollachius	616	606767444	985012.08	27399917	31536354.19	8	53464670	1000	2426	606405444	249961.02	606672	921884.56	254	4276471	1000	1810	362000	200.00	200	200.00	905	200	200	164696812:138576215:138347969:164784448	45.67	194809672	2426	606405444	249961.02	1810	616
GCA_964030765.1	fMicPou1	Micromesistius poutassou	3832	520636573	135865.49	19932791	18026493.40	12	30431094	1000	6887	520025573	75508.29	238748	405066.44	525	3294000	1000	3055	611000	200.00	200	200.00	1528	200	200	140993223:119077264:119185715:140769371	45.82	173858339	6887	520025573	75508.29	3055	3832
GCA_047511565.1	fPolLow2	Polymixia lowei	327	675344950	2065275.08	28554946	27966571.04	11	38460444	11937	1079	675194523	625759.52	1684680	2907764.48	97	11969036	11937	752	150427	200.04	200	200.04	376	227	200	191225860:146562868:146326856:191078939	43.38	193454555	1079	675194523	625759.52	752	327
GCA_048537225.1	fPolHol1	Polymixia cf. hollisterae	846	722757191	854322.92	27609221	27025806.09	12	42982685	4383	1327	722662791	544583.87	4150567	5910131.35	45	21252126	4383	481	94400	196.26	200	198.09	236	200	100	205628891:155217646:155300631:206515623	42.97	227839680	1327	722662791	544583.87	481	846
GCA_964638095.1	fPorCra3	Poromitra crassiceps	2788	1630001977	584649.20	53864884	57469345.16	11	131550215	1000	5763	1629406977	282735.90	841497	1134517.69	534	6192179	1000	2975	595000	200.00	200	200.00	1488	200	200	451883265:363043286:362463259:452017167	44.53	813677991	5763	1629406977	282735.90	2975	2788
GCA_048128805.1	fCenGer3	Centroberyx gerrardi	279	779177424	2792750.62	32609585	31761813.44	11	38969015	8562	978	779037624	796561.99	6370452	7556143.91	35	23513450	8562	699	139800	200.00	200	200.00	350	200	200	224016212:165594663:165297474:224129275	42.47	239157471	978	779037624	796561.99	699	279
GCA_902150065.1	fMyrMur1	Myripristis murdjan	87	835254674	9600628.44	34950760	35291764.50	11	47119472	862	340	833388842	2451143.65	14475636	13759310.80	20	29021625	862	253	1865832	7374.83	221824	243557.64	4	447266	13	242427220:174278908:174327682:242355032	41.83	226963403	340	833388842	2451143.65	253	87
GCA_902500255.1	fThaAma1	Thalassophryne amazonica	464	2446592878	5272829.48	118421481	114997681.37	9	175462960	890	3018	2433998612	806493.91	2319587	2907614.59	311	15558763	40	2554	12594266	4931.19	78927	277357.06	30	1256096	1	705893942:510922695:511010689:706171286	41.99	1451630939	3018	2433998612	806493.91	2554	464
GCA_009829125.3	fPerMag1	Periophthalmus magnuspinnatus	123	752622057	6118878.51	32865169	31782712.79	11	36988977	838	824	745443296	904664.19	2301275	3306194.64	87	12190249	1	701	7178761	10240.74	200180	273679.85	10	719544	1	222797647:149863498:149934979:222847172	40.22	283585713	824	745443296	904664.19	701	123
GCA_951799975.1	fGobNig1	Gobius niger	298	870572126	2921382.97	36708673	38495115.79	10	76501732	1000	934	870444926	931953.88	3365000	3903972.16	81	14051130	1000	636	127200	200.00	200	200.00	318	200	200	251852950:183236834:183259357:252095785	42.10	344168527	934	870444926	931953.88	636	298
GCA_901709675.2	fSynAcu1	Syngnathus acus	88	324347687	3685769.17	14974571	16326838.67	8	28444102	16454	131	324333987	2475831.96	11959915	12454283.20	11	25879647	3530	43	13700	318.60	500	412.41	14	500	100	91702833:70477215:70493545:91660394	43.46	82255147	131	324333987	2475831.96	43	88
GCA_048301445.1	fSynTyp1	Syngnathus typhle	152	368300239	2423027.89	15752117	15435475.66	9	28315844	16489	230	368292439	1601271.47	5638113	6031423.49	22	14716649	2816	78	7800	100.00	100	100.00	39	100	100	104576141:79630547:79564841:104520910	43.23	130394196	230	368292439	1601271.47	78	152
GCA_048301465.1	fAulMac1	Aulostomus maculatus	160	662945422	4143408.89	28137510	26930079.33	11	34787836	1000	339	662927522	1955538.41	6127553	6934420.80	36	19560755	1000	179	17900	100.00	100	100.00	90	100	100	188460966:143329801:143067639:188069116	43.20	168318853	339	662927522	1955538.41	179	160
GCA_910596095.1	fThuMac1	Thunnus maccoyii	58	782423977	13490068.57	33761101	32819864.01	11	41002747	8768	153	782392477	5113676.32	26803536	22678456.02	13	34584767	8768	95	31500	331.58	500	449.21	32	500	100	235880022:155385792:155463278:235663385	39.73	203981740	153	782392477	5113676.32	95	58
GCA_963924715.1	fThuThy2	Thunnus thynnus	120	799063593	6658863.28	34318521	33408129.06	11	42008130	1000	588	798969993	1358792.51	2956553	3423412.66	84	8921091	1000	468	93600	200.00	200	200.00	234	200	200	240573088:158879072:158892957:240624876	39.77	215945314	588	798969993	1358792.51	468	120
GCA_914725855.1	fThuAlb1	Thunnus albacares	69	792117861	11479969.00	34622995	33478774.71	11	41207429	10124	139	792094561	5698522.02	26795544	23885609.86	13	37025965	10124	70	23300	332.86	500	399.57	24	500	200	238819647:157233798:157475829:238565287	39.73	208085508	139	792094561	5698522.02	70	69
GCA_027409825.1	fScoJap1	Scomber japonicus	361	828697720	2295561.55	34636535	34582644.25	11	44105842	3099	1933	828050620	428375.90	4898551	6032823.17	46	20214033	3099	1572	647100	411.64	500	457.07	648	500	200	248401920:165668406:165673458:248306836	40.01	261422846	1933	828050620	428375.90	1572	361
GCA_963691925.1	fScoSco1	Scomber scombrus	666	764157853	1147384.16	31095048	29954663.85	12	38754833	1000	2155	763860031	354459.41	1496448	1930564.37	140	7574035	1000	1489	297822	200.01	200	200.02	745	222	200	229552863:152375712:151499406:230432050	39.78	222738379	2155	763860031	354459.41	1489	666
GCA_042242135.1	fArrGeo1	Arripis georgiana	552	801586327	1452149.14	28384748	23865857.85	13	36028805	8733	650	801566927	1233179.89	15715076	14357458.91	18	29748398	8733	98	19400	197.96	200	198.97	49	200	100	241307916:159479566:159271506:241507939	39.77	304295349	650	801566927	1233179.89	98	552
GCA_900324485.3	fMasArm1	Mastacembelus armatus	123	591951591	4812614.56	25090313	23842908.99	11	29124071	924	361	578720247	1603103.18	7788594	7971640.31	26	20754100	924	238	13231344	55593.88	282970	274955.81	17	607827	2	171730494:117623414:117670717:171695622	40.66	135012440	361	578720247	1603103.18	238	123
GCA_900324465.3	fAnaTes1	Anabas testudineus	51	555658509	10895264.88	25063394	24755444.70	10	34285027	12604	317	552052013	1741489.00	7055436	7482444.27	25	16967553	12604	266	3606496	13558.26	110000	162049.82	9	482892	25	164504918:111536942:111512105:164498048	40.40	114941221	317	552052013	1741489.00	266	51
GCA_900634795.4	fBetSpl5	Betta splendens	35	426984265	12199550.43	19821211	21455953.84	9	34127283	25057	346	426952799	1233967.63	2574972	3680134.64	46	12467171	14974	321	31466	98.02	123	145.55	87	423	23	116664944:96709116:96745237:116833502	45.31	95920757	346	426952799	1233967.63	321	35
GCA_017976425.1	fToxJac2	Toxotes jaculatrix	96	621503431	6473994.07	26859436	26655284.92	11	32862146	22722	194	620365959	3197762.68	15555772	14187879.82	16	25993797	19380	98	1137472	11606.86	297451	263236.85	2	417859	13	183024103:127730097:127272468:182339291	41.11	170387963	194	620365959	3197762.68	98	96
GCA_009819705.1	fHipHip1	Hippoglossus hippoglossus	57	596792676	10470046.95	26312018	25745762.67	11	32675587	1459	347	593379286	1710026.76	7020318	9134423.79	23	21516758	166	290	3413390	11770.31	109387	121468.53	11	271614	13	171472042:125241079:125246350:171419815	42.21	139276072	347	593379286	1710026.76	290	57
GCA_947347685.1	fPlePla1	Pleuronectes platessa	356	687405470	1930914.24	26648505	24626229.40	12	33765178	1000	1428	687191070	481226.24	1477112	2156175.46	118	9084626	1000	1072	214400	200.00	200	200.00	536	200	200	197658449:146153211:145950419:197428991	42.51	225503064	1428	687191070	481226.24	1072	356
GCA_949316205.1	fPlaFle2.1	Platichthys flesus	109	597138466	5478334.55	26770804	25163807.84	11	31329391	9855	591	597042066	1010223.46	2078972	2907570.13	80	12042508	9855	482	96400	200.00	200	200.00	241	200	200	171381467:127263097:127012991:171384511	42.59	150612042	591	597042066	1010223.46	482	109
GCA_963576545.1	fLimLim1	Limanda limanda	339	717597899	2116807.96	28632645	25879617.67	12	41843667	16603	614	717542899	1168636.64	3420448	4646656.80	55	14028829	16603	275	55000	200.00	200	200.00	138	200	200	205761276:152952008:153244864:205584751	42.67	245452258	614	717542899	1168636.64	275	339
GCA_964266715.1	fMicKit1	Microstomus kitt	1581	752333918	475859.53	25769083	22165350.65	13	34612063	1000	1990	752252118	378016.14	2288625	2775296.35	94	9019000	1000	409	81800	200.00	200	200.00	205	200	200	219373794:156394840:156320501:220162983	41.57	271324861	1990	752252118	378016.14	409	1581
GCA_958295425.1	fSolSol10.1	Solea solea	243	643774986	2649279.78	29068826	29831758.60	10	47064963	1000	616	643700386	1044968.16	2587297	3139022.85	77	11520506	1000	373	74600	200.00	200	200.00	187	200	200	190409776:131560901:131520801:190208908	40.87	206364134	616	643700386	1044968.16	373	243
GCA_963457635.1	fMicVar1	Microchirus variegatus	188	724694306	3854756.95	29835075	30559493.01	10	47546321	1000	642	724603506	1128665.90	2444644	3012731.79	90	9798444	1000	454	90800	200.00	200	200.00	227	200	200	216335268:146169020:146319713:215779505	40.37	285158002	642	724603506	1128665.90	454	188
GCA_963854745.1	fScoMax1	Scophthalmus maximus	108	550297089	5095343.42	26138615	25612765.32	10	33057255	1000	913	550136089	602558.70	1410686	1844363.06	111	8478567	1000	805	161000	200.00	200	200.00	403	200	200	155816531:119321579:119442892:155555087	43.40	139144635	913	550136089	602558.70	805	108
GCA_900963305.2	fEcheNa1	Echeneis naucrates	38	544229243	14321822.18	23287306	22817327.90	11	28058824	16610	178	543629887	3054100.49	12371513	11549960.05	17	24563878	72	140	599356	4281.11	129073	153779.88	2	248230	13	159274449:112565889:112647628:159141921	41.43	115185947	178	543629887	3054100.49	140	38
GCA_905171665.2	fTraTra1	Trachurus trachurus	153	801243942	5236888.51	35447499	33541924.41	11	40754244	9798	375	801214780	2136572.75	6490592	8438522.12	35	21747208	11	222	29162	131.36	123	287.06	35	523	23	232537162:167967457:168070382:232639779	41.94	256156955	375	801214780	2136572.75	222	153
GCA_900634625.2	fParRan2	Parambassis ranga	157	551029983	3509745.11	22993012	23683880.92	10	46703924	1172	1680	540468435	321707.40	5080925	5998094.26	31	17068833	6	1523	10561548	6934.70	13447	27383.97	182	153246	1	155682214:114539197:114520810:155726214	42.38	134255659	1680	540468435	321707.40	1523	157
GCA_964374335.1	fAstCal1	Astatotilapia calliptera	31	933429770	30110637.74	39779922	45781898.53	10	85450608	16582	71	933425270	13146834.79	28161480	29033185.53	13	63580080	16582	40	4500	112.50	100	122.22	18	200	100	274641427:192016426:192167804:274599613	41.16	296483466	71	933425270	13146834.79	40	31
GCA_007364275.2	fArcCen1	Archocentrus centrarchus	189	932947025	4936227.65	35590001	31062583.64	13	43489282	6452	933	916043548	981825.88	2143410	2634444.67	129	8648377	1	744	16903477	22719.73	258816	467934.54	14	1459709	1	269147665:188861792:188830940:269203151	41.23	280709583	933	916043548	981825.88	744	189
GCA_963969265.1	fRhaChi2	Rhamphochromis sp. chilingali	82	921184210	11233953.78	39959964	44189497.64	10	72946008	1000	504	921099810	1827578.99	4163600	4891338.98	71	14381365	1000	422	84400	200.00	200	200.00	211	200	200	270986714:189538773:189652625:270921698	41.17	300852542	504	921099810	1827578.99	422	82
GCA_965226115.1	fAulStu2	Aulonocara stuartgranti	23	945383024	41103609.74	40335072	45844384.89	10	80478882	16584	54	945378724	17507013.41	37447771	34534141.39	11	69801386	16584	31	4300	138.71	200	155.81	11	200	100	278148970:194496147:194547279:278186328	41.15	308647866	54	945378724	17507013.41	31	23
GCA_020382885.1	fScaArg1	Scatophagus argus	48	570802272	11891714.00	24451451	24333584.96	11	29849514	16771	125	569090713	4552725.70	17189422	15508664.92	14	27124904	16771	77	1711559	22228.04	218670	193769.90	4	307685	10	166453368:118085702:118009157:166542486	41.49	117757757	125	569090713	4552725.70	77	48
GCA_014839685.1	fAnaAna1	Anableps anableps	33	867632993	26291908.88	39321252	37100784.05	11	43378579	1800	140	867326434	6195188.81	17460000	18100911.61	17	41113619	1800	107	306559	2865.04	110387	110258.56	2	144770	13	266505683:167119603:167146094:266555054	38.54	254102268	140	867326434	6195188.81	107	33
GCA_021462225.2	DD_fGirMul_XY1	Girardinichthys multiradiatus	73	1150020615	15753707.05	47419401	46679099.43	12	53595138	15762	482	1143848515	2373129.70	13818222	15771345.55	25	36915635	1	409	6172100	15090.71	278644	682478.48	5	1872598	1	342136333:229838293:229727931:342145958	40.18	434972284	482	1143848515	2373129.70	409	73
GCA_037039145.1	fFunDia1	Fundulus diaphanus	331	1351828608	4084074.34	57717734	55360138.38	12	65899194	11324	624	1348366868	2160844.34	11036555	13520312.22	35	41039661	11324	293	3461740	11814.81	91382	91197.60	13	172721	13	396178703:277923548:278025368:396239249	41.23	562366715	624	1348366868	2160844.34	293	331
GCA_963514085.1	fCheLab1	Chelon labrosus	363	717420143	1976364.03	30303911	28670714.39	12	39510717	1000	973	717298143	737202.61	2544200	3151085.65	85	9746000	1000	610	122000	200.00	200	200.00	305	200	200	206783744:151672755:151769511:207072133	42.30	192577186	973	717298143	737202.61	610	363
GCA_017639745.1	fMelBoe1	Melanotaenia boesemani	93	865592505	9307446.29	37878235	36299080.61	11	44752309	874	533	862374604	1617963.61	9299978	10182726.36	28	27050739	165	440	3217901	7313.41	216060	201934.10	6	479078	12	260146653:170902061:171051044:260274846	39.65	245125547	533	862374604	1617963.61	440	93
GCA_933228915.1	fTelBon1	Telmatherina bonti	146	986039709	6753696.64	41523244	41052471.27	12	48058054	1000	1475	985773909	668321.29	1254875	1500994.26	246	5328072	1000	1329	265800	200.00	200	200.00	665	200	200	287842570:205580620:205105785:287244934	41.66	383660111	1475	985773909	668321.29	1329	146
GCA_027942865.1	fOdoBon6	Odontesthes bonariensis	189	945823896	5004359.24	39252737	39209294.32	12	48530455	10916	471	945732096	2007923.77	9831534	11257628.14	29	28577103	10916	282	91800	325.53	500	392.81	92	500	200	276297214:196431499:196188214:276815169	41.51	322887591	471	945732096	2007923.77	282	189
GCA_048628825.1	fMenAtl1	Menidia menidia	457	571276089	1250057.09	23854799	22866302.07	11	30213143	1000	1324	571189389	431411.93	4610982	6708135.87	29	19931239	1000	867	86700	100.00	100	100.00	434	100	100	165129140:120434710:120416963:165208576	42.17	157332091	1324	571189389	431411.93	867	457
GCA_014839995.1	fXenCan1	Xenentodon cancila	410	736214936	1795646.19	28679447	28974647.65	12	36457923	12323	1783	728711352	408699.58	2195850	3109679.04	83	12314416	19	1373	7503584	5465.10	174451	268815.65	11	713629	6	213356400:150931192:150799142:213624618	41.41	195145153	1783	728711352	408699.58	1373	410
GCA_020510985.1	fPhoLeu1	Pholidichthys leucotaenia	512	6032307556	11781850.70	435632707	412389259.16	7	501236086	766	3092	5979526732	1933870.22	5866050	7242616.88	304	30826243	55	2580	52780824	20457.68	407843	618599.76	35	2006918	3	1658801355:1330886118:1330993244:1658846015	44.52	4483515825	3092	5979526732	1933870.22	2580	512
GCA_949357725.1	fHypImm3	Hyperoplus immaculatus	1568	797804280	508803.75	31412174	28598674.29	12	38608367	1000	2756	797566680	289392.84	1486508	1761179.32	160	7214000	1000	1188	237600	200.00	200	200.00	594	200	200	234924337:163816323:164015084:234810936	41.10	314165629	2756	797566680	289392.84	1188	1568
GCA_949987685.1	fAmmMar1	Ammodytes marinus	617	777835610	1260673.60	31846471	30198617.37	12	39742375	1000	1634	777632210	475907.11	2041615	2499417.32	115	11859408	1000	1017	203400	200.00	200	200.00	509	200	200	228533616:160117672:160417430:228563492	41.22	299724053	1634	777632210	475907.11	1017	617
GCA_902148845.1	fSalaFa1	Salarias fasciatus	202	797490645	3947973.49	32729575	31502071.61	11	41705463	3075	804	787042748	978908.89	2597836	3549393.36	86	15801682	806	602	10447897	17355.31	464238	529855.50	8	1418808	13	218986541:174513061:174461288:219081858	44.34	203942762	804	787042748	978908.89	602	202
GCA_963422515.1	fBleOce1	Blennius ocellaris	525	728745255	1388086.20	29635927	26993794.03	12	37598765	1000	2150	728420255	338800.12	1116256	1267673.40	202	5130559	1000	1625	325000	200.00	200	200.00	813	200	200	207167951:157572514:156764344:206915446	43.15	228194058	2150	728420255	338800.12	1625	525
GCA_963383615.1	fLipPho2	Lipophrys pholis	847	768243328	907016.92	31905247	31092609.87	11	55899835	1000	1445	768123712	531573.50	3299550	4101843.01	68	15023454	1000	598	119616	200.03	200	200.03	299	216	200	222552128:161749367:161431374:222390843	42.07	213384645	1445	768123712	531573.50	598	847
GCA_049082185.1	fCriAus1	Cristiceps australis	793	619674967	781431.23	26025653	24077917.16	11	38431221	3392	1973	619440267	313958.57	1816655	2838566.38	86	13778008	3392	1180	234700	198.90	200	199.45	587	200	100	171995187:138302195:137727106:171415779	44.56	179588763	1973	619440267	313958.57	1180	793
GCA_048569125.1	fDirArg1	Diretmus argenteus	5504	1517026147	275622.48	41803795	30957241.03	16	56497672	2184	8869	1516359347	170972.98	542425	866030.46	693	5144678	2184	3365	666800	198.16	200	199.07	1667	200	100	423557958:333708819:335017160:424075410	44.10	751095275	8869	1516359347	170972.98	3365	5504
GCA_043641665.1	fEnoArm2	Enoplosus armatus	135	579881259	4295416.73	25576037	24512409.87	11	31379816	6000	249	579858759	2328750.04	17101116	15248301.38	14	27283186	6000	114	22500	197.37	200	198.67	57	200	100	168229895:121762464:121798336:168068064	42.00	129998885	249	579858759	2328750.04	114	135
GCA_019677235.1	fMicSal1	Micropterus salmoides	202	877669248	4344897.27	37181689	37646992.22	11	56195885	723	874	877334246	1003814.93	5637587	8227554.71	39	31010494	723	672	335002	498.51	500	500.00	336	500	1	259394396:179223866:179338265:259377719	40.87	249639379	874	877334246	1003814.93	672	202
GCA_009762535.1	fNotCel1	Notolabrus celidotus	468	846760650	1809317.63	37090664	34741486.69	11	42375795	2375	1603	832492169	519333.85	3748462	4545485.68	64	15274844	2	1135	14268481	12571.35	155974	244215.46	20	649632	1	246283329:170059809:170080673:246068358	40.86	275074018	1603	832492169	519333.85	1135	468
GCA_020745685.1	fTauAds1	Tautogolabrus adspersus	64	723582185	11305971.64	31691308	30969509.49	11	37089861	533	347	719325965	2072985.49	7919333	9645002.25	27	24542842	533	283	4256220	15039.65	148732	343025.45	7	1019239	13	211095559:148474978:148680928:211074500	41.31	195117918	347	719325965	2072985.49	283	64
GCA_963584025.1	fLabMix1	Labrus mixtus	325	740579663	2278706.66	30403003	28277612.53	12	36961920	1000	895	740465649	827335.92	2678957	3616424.39	75	13836681	1000	570	114014	200.02	200	200.03	285	214	200	219108695:150940841:150956996:219459117	40.77	245630357	895	740465649	827335.92	570	325
GCA_963930695.1	fLabBer1	Labrus bergylta	132	720227340	5456267.73	31261685	30587692.91	11	38007505	1000	947	720064340	760363.61	2715806	3304374.86	79	11782793	1000	815	163000	200.00	200	200.00	408	200	200	213741730:146342192:145950015:214030403	40.59	213222424	947	720064340	760363.61	815	132
GCA_947650265.1	fSymMel2	Symphodus melops	395	636368453	1611059.37	27641414	28816250.99	10	56958096	1000	1774	636092653	358564.07	1186940	1463096.39	156	5978371	1000	1379	275800	200.00	200	200.00	690	200	200	184948256:132925486:133097878:185121033	41.82	178562354	1774	636092653	358564.07	1379	395
GCA_047301625.1	fChoSch1	Choerodon schoenleinii	43	865958939	20138579.98	38173469	36274165.36	11	43504620	25000	54	865957839	16036256.28	37536982	34597620.32	11	43504620	25000	11	1100	100.00	100	100.00	6	100	100	253060198:180087492:179832748:252977401	41.56	253424643	54	865957839	16036256.28	11	43
GCA_900634415.1	fCotGob3	Cottoperca gobio	322	609391784	1892521.07	25156145	23496921.88	11	30479438	3451	767	606837809	791183.58	5939854	7591914.71	28	22111475	6	445	2553975	5739.27	242900	240145.42	4	500417	9	178982552:124297770:124257939:179299548	40.96	169191857	767	606837809	791183.58	445	322
GCA_904848185.1	fAcaLat1	Acanthopagrus latus	65	685127588	10540424.43	30717905	28876135.05	11	35910746	24678	214	685112688	3201461.16	14880455	12703409.57	18	23498676	6946	149	14900	100.00	100	100.00	75	100	100	198395240:144250144:144109362:198357942	42.09	152088249	214	685112688	3201461.16	149	65
GCA_910591455.2	fPhoGun1	Pholis gunnellus	101	588696950	5828682.67	25364761	25181568.69	11	31680502	11199	519	588559950	1134026.88	3519450	4199732.08	51	14088283	10162	418	137000	327.75	500	447.45	137	500	100	169757555:124586401:124453326:169762668	42.31	140850849	519	588559950	1134026.88	418	101
GCA_028022725.1	fLycPai1	Lycodopsis pacificus	109	646369862	5929998.73	27720618	26932372.53	11	33962080	1000	475	646296662	1360624.55	4715471	5880790.82	39	16238479	1000	366	73200	200.00	200	200.00	183	200	200	184122236:138819904:138982651:184371871	42.98	187789882	475	646296662	1360624.55	366	109
GCA_949748355.1	fMelGel1.1	Melanostigma gelatinosum	534	661975483	1239654.46	27978033	25542901.33	11	33869925	1000	1123	661856283	589364.46	1934223	2300672.72	103	6981126	1000	589	119200	202.38	200	204.70	291	400	200	192524299:138688696:138491049:192152239	41.88	214105114	1123	661856283	589364.46	589	534
GCA_949606895.1	fNotRos5.1	Notothenia rossii 	943	1042906029	1105944.89	89684120	80594044.55	6	97391511	1000	5100	1042074629	204328.36	383412	526665.99	770	3027947	1000	4157	831400	200.00	200	200.00	2079	200	200	305651173:215989719:216084786:304348951	41.46	458600357	5100	1042074629	204328.36	4157	943
GCA_963514095.1	fEutGur1	Eutrigla gurnardus	319	680483561	2133177.31	29198404	27331091.06	11	37750515	1000	872	680372961	780244.22	2351664	2741606.25	88	8085252	1000	553	110600	200.00	200	200.00	277	200	200	193514680:146614593:146853140:193390548	43.13	198922317	872	680372961	780244.22	553	319
GCA_048129235.1	fEpiMut1	Epinephelus rankini	386	1035398499	2682379.53	41744182	40893601.96	12	49657586	6945	407	1035394299	2543966.34	36345755	32618232.58	13	45199080	6945	21	4200	200.00	200	200.00	11	200	200	304040845:214066744:214131978:303154732	41.36	314029238	407	1035394299	2543966.34	21	386
GCA_041903045.1	fEpiLan1	Epinephelus lanceolatus	176	1089387278	6189700.44	45765254	45519832.34	12	53692833	248	183	1089383778	5952916.82	44383456	43040597.05	12	53692833	248	7	3500	500.00	500	500.00	4	500	500	319695814:225213128:225249389:319225447	41.35	346628224	183	1089383778	5952916.82	7	176
GCA_017976325.1	fCheRos1	Chelmon rostratus	29	644208416	22214083.31	27778429	27477894.51	11	33767321	16523	89	644197036	7238168.94	16959746	16466865.56	15	29002362	618	60	11380	189.67	200	269.52	18	500	16	184939794:137137365:137074693:185045184	42.57	134642605	89	644197036	7238168.94	60	29
GCA_039877785.1	fChaTrf1	Chaetodon trifascialis	37	662505520	17905554.59	29139200	28122090.14	11	35129900	16497	86	662495920	7703440.93	21327470	18942293.02	13	34891952	16497	49	9600	195.92	200	197.92	24	200	100	189490805:141782613:141705937:189516565	42.79	149750967	86	662495920	7703440.93	49	37
GCA_045363895.1	fPriTyp1	Pristipomoides typus	283	1147302341	4054071.88	49091459	46981405.50	11	56331368	7404	367	1147285741	3126119.19	20615779	24446992.73	17	48432439	7404	84	16600	197.62	200	198.80	42	200	100	345166761:228493765:228376532:345248683	39.82	394664938	367	1147285741	3126119.19	84	283
GCA_048128725.1	fSymNem1	Symphorus nematophorus	86	1079363760	12550741.40	46473589	45469810.94	11	55338275	9566	156	1079350460	6918913.21	40433363	35298590.91	12	54915531	9566	70	13300	190.00	200	194.74	34	200	100	327703674:212140024:212114459:327392303	39.31	346753571	156	1079350460	6918913.21	70	86
GCA_048129055.1	fCaeTer1	Caesio teres	323	1078118487	3337828.13	42904923	40575371.47	12	65931628	9111	352	1078112687	3062820.13	36254855	33033980.74	13	63504530	9111	29	5800	200.00	200	200.00	15	200	200	319839866:219455634:219428411:319388776	40.71	352780070	352	1078112687	3062820.13	29	323
GCA_900880675.2	fSpaAur1	Sparus aurata	176	833595063	4736335.59	35791275	34107722.25	11	41392777	16652	1226	833252795	679651.55	2862625	3941375.36	75	12576271	2	1050	342268	325.97	500	431.63	343	500	3	241989233:174806947:174681847:241774768	41.94	208049446	1226	833252795	679651.55	1050	176
GCA_965226575.1	fPagPag1	Pagrus pagrus	576	825699107	1433505.39	32080377	30198999.07	12	38652747	1000	1112	825591907	742438.77	2517928	3015425.05	100	11601826	1000	536	107200	200.00	200	200.00	268	200	200	240942474:172541713:171981515:240126205	41.73	236298480	1112	825591907	742438.77	536	576
GCA_041753875.1	fAcaSch1	Acanthopagrus schlegelii	24	714975658	29790652.42	31795397	30394078.26	11	37352144	18536763	24	714975658	29790652.42	31795397	30394078.26	11	37352144	18536763	0	0	0.00	0	0.00	0	0	0	207294898:150270000:150243569:207167191	42.03	167666215	24	714975658	29790652.42	0	24
GCA_045362495.1	fLetNeb1	Lethrinus nebulosus	226	1133212262	5014213.55	48261062	46815279.57	12	55243022	4531	422	1133173562	2685245.41	21706182	22504140.56	18	46802027	4531	196	38700	197.45	200	198.71	97	200	100	336558273:229887563:230078730:336648996	40.59	319190222	422	1133173562	2685245.41	196	226
GCA_013358685.1	fAntMac1	Antennarius maculatus	155	549949511	3548061.36	22928215	22776293.17	11	31734190	11833	374	549216127	1468492.32	10114706	11298168.40	17	28941471	1999	219	733384	3348.79	100295	94579.34	3	182128	57	159721946:114941174:114975324:159577683	41.86	158512648	374	549216127	1468492.32	219	155
GCA_901000725.3	fTakRub1	Takifugu rubripes	128	384126663	3000989.55	16705553	17043628.82	10	29232231	16448	530	380438134	717807.80	3136617	3869374.05	35	13376190	1293	402	3688529	9175.45	138644	165595.06	9	428276	10	103350305:86838145:86894471:103355213	45.67	77206756	530	380438134	717807.80	402	128
GCA_042242105.1	fPemKlu1	Pempheris klunzingeri	441	646252061	1465424.17	27715216	26050106.44	11	36727992	10110	528	646234861	1223929.66	12920725	14066837.40	17	29811818	10110	87	17200	197.70	200	198.84	43	200	100	187909903:135162475:135290352:187872131	41.85	153423364	528	646234861	1223929.66	87	441
GCA_031216445.1	fLatMac1	Lateolabrax maculatus	109	632510465	5802848.30	27954791	26512650.29	11	32929622	287	109	632510465	5802848.30	27954791	26512650.29	11	32929622	287	0	0	0.00	0	0.00	0	0	0	186496667:130007968:129752036:186253794	41.07	161556211	109	632510465	5802848.30	0	109
GCA_902148855.1	fSphaOr1	Sphaeramia orbicularis	340	1342662642	3949007.77	57165184	55608981.89	11	81199652	1109	2184	1339096561	613139.45	2360121	3298014.09	148	16486228	344	1844	3566081	1933.88	79867	104702.93	13	295227	7	415855197:253837474:253716090:415687800	37.90	638820221	2184	1339096561	613139.45	1844	340
GCA_900634775.2	fGouWil1	Gouania willdenowi	442	937169869	2120293.82	38978045	38093586.58	11	72451976	11803	1602	922816354	576040.17	1838341	2770225.83	132	14528139	1	1160	14353515	12373.72	746162	932260.12	6	2682546	1	284868003:176634278:176542617:284771456	38.27	392996761	1602	922816354	576040.17	1160	442
GCA_963691815.1	fEchVip8	Echiichthys vipera	133	800398249	6018031.95	33039917	32820866.68	11	48328199	1000	739	800277049	1082918.88	2579157	3027647.73	96	10142738	1000	606	121200	200.00	200	200.00	303	200	200	233702528:167548898:167071085:231954538	41.81	258746331	739	800277049	1082918.88	606	133
GCA_009769545.1	fCycLum1	Cyclopterus lumpus	49	572902877	11691895.45	23863342	23848609.21	11	31498552	1528	396	562720673	1421011.80	4950682	5550169.96	35	15356175	1528	347	10182204	29343.53	149379	218801.59	19	787556	13	161048890:120472270:120519475:160680038	42.83	154309297	396	562720673	1421011.80	347	49
GCA_015220745.1	fSebUmb1	Sebastes umbrosus	139	800921631	5762026.12	34912176	33754050.28	11	44063945	3314	354	799527739	2258552.94	11445908	11876791.11	24	22823328	933	215	1393892	6483.22	53481	102684.83	6	266635	13	236775625:163059279:162879366:236813469	40.77	282486653	354	799527739	2258552.94	215	139
GCA_043250625.1	fSebFas1	Sebastes fasciatus	203	833835073	4107561.94	36314571	35186726.68	11	46713506	6737	674	833750873	1237019.10	7769413	9481484.12	32	28624128	141	471	84200	178.77	200	188.12	211	200	100	246189749:170749526:170284260:246527338	40.90	300169126	674	833750873	1237019.10	471	203
GCA_910589615.1	fTauBub2	Taurulus bubalis	27	615153901	22783477.81	29138660	31790252.00	9	50132026	16828	269	615076801	2286530.86	13037006	11548219.54	18	22858722	11076	242	77100	318.60	500	386.64	78	500	100	177701315:129867738:129795756:177711992	42.22	169081064	269	615076801	2286530.86	242	27
GCA_048126635.1	fSpiSpi1	Spinachia spinachia	38	407561107	10725292.29	19449660	21791122.26	8	35838203	19352	279	407537007	1460706.12	6606641	8175984.49	17	19673868	18301	241	24100	100.00	100	100.00	121	100	100	112379359:91362138:91332461:112463049	44.83	90653231	279	407537007	1460706.12	241	38
GCA_949316345.1	fPunPun2.1	Pungitius pungitius	175	480450674	2745432.42	21005440	22689150.29	10	35745030	1000	913	480303074	526071.27	1362288	1912632.18	97	8913000	1000	738	147600	200.00	200	200.00	369	200	200	134415844:105820888:106108908:133957434	44.12	133014368	913	480303074	526071.27	738	175
GCA_964276395.1	fgasAcu3	Gasterosteus aculeatus	130	511155287	3931963.75	21933526	23244013.74	10	36158614	1000	461	511089087	1108653.12	2544530	3079499.20	63	12023602	1000	331	66200	200.00	200	200.00	166	200	200	141157678:114293122:114236194:141402093	44.71	127696117	461	511089087	1108653.12	331	130
GCA_044231665.1	fSynOce1	Neosynchiropus ocellatus	107	470091028	4393374.09	23008753	24482065.74	8	37209138	1000	206	470081128	2281947.22	19762325	16731412.29	10	30165802	1000	99	9900	100.00	100	100.00	50	100	100	128262465:106768099:106719343:128331221	45.42	98579318	206	470081128	2281947.22	99	107
GCA_044231675.1	fSynPic1	Synchiropus picturatus	300	492062741	1640209.14	23137118	23990486.22	9	36199747	1000	400	492052741	1230131.85	17238139	16939810.13	11	30934342	1000	100	10000	100.00	100	100.00	50	100	100	139114372:107039823:106902841:138995705	43.48	118391044	400	492052741	1230131.85	100	300
GCA_035084275.1	sHydCol1	Hydrolagus colliei	532	1003172678	1885662.93	42627691	72370790.04	5	156096171	14133	2484	1002782278	403696.57	1059761	1725336.61	231	10939731	14133	1952	390400	200.00	200	200.00	976	200	200	286595722:214810067:214848529:286527960	42.85	426640582	2484	1002782278	403696.57	1952	532
GCA_036365525.1	sHetFra1	Heterodontus francisci	2307	6013065386	2606443.60	90140832	98403380.27	21	287946412	13349	5088	5984695865	1176237.39	3418954	4461003.09	500	22199025	13349	2781	28369521	10201.19	50502	111783.42	141	842671	13	1642238236:1349038603:1346859234:1646559792	45.05	4108152809	5088	5984695865	1176237.39	2781	2307
GCA_020745735.1	sHemOce1	Hemiscyllium ocellatum	1963	3983483121	2029283.30	83580160	82692222.15	17	167561909	1132	5679	3905918439	687782.79	8845575	14451763.30	94	55529653	438	3716	77564682	20873.17	164083	235562.40	127	1248970	1	1117271371:835014042:835341171:1118291855	42.76	1721301190	5679	3905918439	687782.79	3716	1963
GCA_030684315.1	sSteTig4	Stegostoma tigrinum	835	3198515386	3830557.35	79021053	83076124.08	14	194051863	7955	1994	3181408905	1595490.93	6162596	8549617.61	136	31236108	7955	1159	17106481	14759.69	67422	343508.19	48	2056108	13	901212207:689559820:691376991:899259887	43.41	1340106666	1994	3181408905	1595490.93	1159	835
GCA_017639515.1	sCarCar2	Carcharodon carcharias	719	4286311192	5961489.84	169918123	153032500.60	11	274107945	989	3364	4267160924	1268478.28	6544962	11521606.76	145	49152995	20	2645	19150268	7240.18	103029	169990.42	44	535743	2	1168011913:966087256:963161266:1169900489	45.21	2210327891	3364	4267160924	1268478.28	2645	719
GCA_964194155.1	sCetMax3	Cetorhinus maximus	5088	3993866540	784958.05	126028485	122817154.48	12	250190555	1000	7866	3993310905	507667.29	1961965	2893538.05	530	15005526	1000	2778	555635	200.01	200	200.01	1389	221	200	1105589405:881779144:894938151:1111004205	44.49	2017544342	7866	3993310905	507667.29	2778	5088
GCA_902713615.2	sScyCan1	Scyliorhinus canicula	645	4220389930	6543240.20	198790641	190492560.82	9	313568160	995	7791	4156169183	533457.73	1855773	2514724.68	616	13395245	31	7146	64220747	8986.95	152174	472384.92	68	2605168	1	1087862218:990583604:989674543:1088048818	47.65	2136908398	7791	4156169183	533457.73	7146	645
GCA_964213995.1	sMusAst1	Mustelus asterias	5314	3679792345	692471.27	109010392	101016872.26	13	202110868	1000	8904	3679074345	413193.43	1197343	1698423.10	829	9328426	1000	3590	718000	200.00	200	200.00	1795	200	200	998685983:837496479:843377989:999513894	45.69	1996112117	8904	3679074345	413193.43	3590	5314
GCA_035084215.1	sHepPer1	Heptranchias perlo	1880	3249935392	1728689.04	66821466	78695866.05	15	198562713	6694	3714	3249568592	874951.16	4905566	7467796.76	162	41169188	6694	1834	366800	200.00	200	200.00	917	200	200	904033007:720274905:721470240:903790440	44.37	1842223263	3714	3249568592	874951.16	1834	1880
GCA_044704955.1	sPriJap1	Pristiophorus japonicus	4317	5923050865	1372029.39	225854410	226796665.22	10	546236482	2401	10302	5921854391	574825.70	1893048	2637844.24	853	15904561	2401	5985	1196474	199.91	200	199.99	2992	200	24	1569982477:1394774375:1389584499:1567513040	47.02	4212202744	10302	5921854391	574825.70	5985	4317
GCA_036971445.1	sNarBan1	Narcine bancroftii	596	3328453053	5584652.77	257710454	272284696.63	5	494489450	14414	2039	3328175288	1632258.60	5195315	8437970.26	160	54857896	7731	1443	277765	192.49	200	196.63	695	200	24	937564340:728638928:714022926:947949094	43.35	1802483284	2039	3328175288	1632258.60	1443	596
GCA_010909765.2	sAmbRad1	Amblyraja radiata	958	2558801738	2670983.03	62052929	77168333.44	13	193168304	1363	4711	2367829205	502617.11	1419197	2021659.93	454	11576558	1360	3753	190972533	50885.30	547539	748641.50	92	3087321	2	659631401:524603110:524267388:659327306	44.30	1322248254	4711	2367829205	502617.11	3753	958
GCA_963514005.1	sRajBra1	Raja brachyura	1647	2700467673	1639628.22	68366687	79714323.36	13	187439314	1000	3916	2700013873	689482.60	2048057	2728157.25	367	12111648	1000	2269	453800	200.00	200	200.00	1135	200	200	742556333:606007527:608385438:743064575	44.98	1569362921	3916	2700013873	689482.60	2269	1647
GCA_009764475.2	sPriPec2	Pristis pectinata	173	2267857790	13109004.57	101699621	84864889.56	10	149968914	1242	871	2247294914	2580131.93	17009522	20739928.71	39	69115116	59	698	20562876	29459.71	166899	240873.61	32	813659	13	647459097:476115207:476267326:647453284	42.38	854301340	871	2247294914	2580131.93	698	173
GCA_030144855.1	sHypSab1	Hypanus sabinus	2990	4044886845	1352804.96	112262883	120378948.46	12	214816651	1000	4638	4044557245	872047.70	4266932	6728792.11	234	38231957	1000	1648	329600	200.00	200	200.00	824	200	200	1144808925:876352892:877107471:1146287957	43.35	2071666048	4638	4044557245	872047.70	1648	2990
GCA_030028105.1	sMobBir1	Mobula birostris	4715	4014635230	851460.28	148671352	136536608.40	10	254321047	10335	6525	3983782600	610541.39	7300797	11707134.52	118	52880397	135	1810	30852630	17045.65	117643	234284.09	67	1667116	13	1129963702:862446494:861085436:1130286968	43.26	2150492037	6525	3983782600	610541.39	1810	4715
GCA_037176945.1	fLatCha2	Latimeria chalumnae	198	2947625464	14886997.29	188107785	219139568.98	5	432068277	7791	352	2947594832	8373848.95	42076942	48582615.30	23	161985814	7791	154	30632	198.91	200	199.82	77	200	32	849245395:624975330:624291526:849082581	42.38	1427545379	352	2947594832	8373848.95	154	198
GCA_040939525.1	kxProAnne1	Protopterus annectens	7125	40524173670	5687603.32	1950821829	1620027903.02	11	2005443657	3083	31563	40518308550	1283728.05	3414998	4435506.05	3375	25093557	3083	24438	5865120	240.00	240	240.00	12219	240	240	12162386251:8095872137:8097411603:12162638559	39.97	22310944443	31563	40518308550	1283728.05	24438	7125
GCA_964187855.1	kmMyxGlut1	Myxine glutinosa	4004	3057523704	763617.31	192170830	200492624.82	6	448543899	1000	8416	3056641608	363194.11	739991	890868.86	1256	4774658	1000	4412	882096	199.93	200	200.00	2206	221	17	851225342:677153036:677594998:850668232	44.32	2239395158	8416	3056641608	363194.11	4412	4004
GCA_048934315.1	kPetMar2	Petromyzon marinus	1203	1808332251	1503185.58	13495987	13502698.90	47	37671560	8628	2195	1808233051	823796.38	4594409	6598970.05	99	27573627	8628	992	99200	100.00	100	100.00	496	100	100	469748180:436603881:433196913:468684077	48.10	1071208841	2195	1808233051	823796.38	992	1203
GCA_964198595.1	kcLamFluv1	Lampetra fluviatilis	1497	1042475189	696376.21	13159252	15183585.76	29	41634058	1000	3292	1042116189	316560.20	1289502	1753074.06	218	7796629	1000	1795	359000	200.00	200	200.00	898	200	200	264619984:256048949:257165876:264281380	49.25	516095801	3292	1042116189	316560.20	1795	1497
GCA_035083965.1	klBraLanc5	Branchiostoma lanceolatum	34	458287516	13479044.59	22634557	26666850.94	8	44478171	20418	137	458272016	3345051.21	11195901	10584612.57	16	18217358	2527	103	15500	150.49	200	167.10	39	200	100	133803130:95400927:95264767:133803192	41.61	120413241	137	458272016	3345051.21	103	34
GCA_019207075.1	iBraBel1	Branchiostoma belcheri	79	405532174	5133318.66	19726665	20996657.52	9	30627739	15847	187	405040145	2165990.08	8162029	8699649.09	17	19841772	1	108	492029	4555.82	253331	131692.13	1	253331	60	118452623:84036595:84092330:118458597	41.51	59950484	187	405040145	2165990.08	108	79
GCA_015852565.1	iBraFlo1	Branchiostoma floridae	341	490782628	1439245.24	24617471	25762942.26	9	34421708	1000	509	490698628	964044.46	6372543	8096283.69	23	22426472	7	168	84000	500.00	500	500.00	84	500	500	143821034:101466242:101516226:143895126	41.37	66429444	509	490698628	964044.46	168	341
GCA_918807975.1	kaAplTurb1	Aplidium turbinatum	27	605507883	22426217.89	34009763	38172461.44	7	64349347	3555	80	605488283	7568603.54	14915238	17940615.25	13	44546892	3555	53	19600	369.81	500	429.59	20	500	200	189018521:113832287:113825338:188812137	37.60	254524248	80	605488283	7568603.54	53	27
GCA_963082875.1	kaCorEumy4	Corella eumyota	105	129324498	1231661.89	20551778	18706744.13	3	23716603	9858	349	129275698	370417.47	5034709	6016034.89	8	13849958	9858	244	48800	200.00	200	200.00	122	200	200	44245893:20411929:20372669:44245207	31.55	64319239	349	129275698	370417.47	244	105
GCA_947623445.1	kaClaLepa1	Clavelina lepadiformis	103	210089204	2039701.01	25070715	23360091.85	4	28789166	1000	161	210077604	1304829.84	8263119	8168579.90	10	14096661	1000	58	11600	200.00	200	200.00	29	200	200	66991604:37809122:37673751:67603127	35.93	69152890	161	210077604	1304829.84	58	103
GCA_964204865.1	kaStyClav1	Styela clava	389	377969001	971642.68	23815600	23534722.12	8	32746820	1000	423	377962201	893527.66	17108000	15270649.68	9	25446714	1000	34	6800	200.00	200	200.00	17	200	200	120721995:68145638:68100125:120994443	36.05	132452621	423	377962201	893527.66	34	389
GCA_963924565.1	kaAscAspe10	Ascidiella aspersa	75	308571401	4114285.35	34997643	34677890.25	4	40963223	2739	468	308497601	659182.91	6569131	6500051.28	17	14641718	2739	393	73800	187.79	200	193.50	185	200	100	96918036:57113719:57130523:97335323	37.03	106571216	468	308497601	659182.91	393	75
GCA_947561715.1	kaAscMent1	Ascidia mentula	96	196975169	2051824.68	21171019	21307445.07	5	27920005	4274	128	196968769	1538818.51	11890000	12242110.72	7	21171019	4274	32	6400	200.00	200	200.00	16	200	200	59858759:38557245:38642931:59909834	39.19	50886791	128	196968769	1538818.51	32	96
GCA_963675345.1	kaTriClin1	Trididemnum clinides	192	906935117	4723620.40	38013173	39057632.17	11	62078107	1000	838	906805717	1082107.06	2293667	2602450.99	128	9077299	1000	646	129400	200.31	200	200.62	323	400	200	280699580:172789133:172698202:280618802	38.10	327148581	838	906805717	1082107.06	646	192
GCA_965202585.1	ktThaDemo2	Thalia democratica	1833	801813394	437432.29	85725539	79489093.30	4	116911807	1000	2245	801766394	357134.25	12003043	15377482.89	20	56498644	1000	412	47000	114.08	100	124.68	177	200	100	299177591:101720009:101660891:299207903	25.37	471695818	2245	801766394	357134.25	412	1833
GCA_902459465.3	eAstRub1	Asterias rubens	151	417618158	2765683.17	20558067	19348074.79	9	33825921	13683	622	417470018	671173.66	1383654	1647530.10	94	6166127	6701	471	148140	314.52	500	440.37	149	500	100	127926410:80941737:80874314:127727557	38.76	153549389	622	417470018	671173.66	471	151
GCA_040954625.2	ASM4095459v1	Balanoglossus misakiensis	100	329694088	3296940.88	12841241	14191749.97	11	20747962	15835	321	329671988	1027015.54	2549480	4068035.59	31	14138001	1633	221	22100	100.00	100	100.00	111	100	100	99351922:65506964:65508084:99305018	39.74	94981173	321	329671988	1027015.54	221	100
